"Województwo","Powiat","Gmina","Teryt","L.uprawnionych.do.głosowania","L.kart.wydanych","L.głosów.oddanych","L.głosów.ważnych","Lech.Aleksander.KACZYŃSKI","Donald.Franciszek.TUSK"
"dolnośląskie","bolesławiecki","Bolesławiec, gm.","020102",9352,4013,4013,3994,2031,1963
"dolnośląskie","bolesławiecki","Bolesławiec, m.","020101",34066,16799,16790,16622,7080,9542
"dolnośląskie","bolesławiecki","Gromadka, gm.","020103",4306,1843,1843,1826,944,882
"dolnośląskie","bolesławiecki","Nowogrodziec, gm.","020104",11310,4565,4565,4511,2385,2126
"dolnośląskie","bolesławiecki","Osiecznica, gm.","020105",5053,2030,2030,2006,822,1184
"dolnośląskie","bolesławiecki","Warta Bolesławiecka, gm.","020106",5997,2359,2359,2351,1281,1070
"dolnośląskie","dzierżoniowski","Bielawa, m.","020201",26659,11849,11843,11759,5391,6368
"dolnośląskie","dzierżoniowski","Dzierżoniów, gm.","020205",7753,3629,3629,3592,2041,1551
"dolnośląskie","dzierżoniowski","Dzierżoniów, m.","020202",29890,14516,14515,14358,6528,7830
"dolnośląskie","dzierżoniowski","Łagiewniki, gm.","020206",5930,2750,2751,2737,1570,1167
"dolnośląskie","dzierżoniowski","Niemcza, gm.","020207",4962,2131,2131,2106,1120,986
"dolnośląskie","dzierżoniowski","Pieszyce, m.","020203",7831,3491,3489,3450,1802,1648
"dolnośląskie","dzierżoniowski","Piława Górna, m.","020204",5343,2260,2251,2225,1277,948
"dolnośląskie","głogowski","Głogów, gm.","020302",4141,1906,1905,1888,1141,747
"dolnośląskie","głogowski","Głogów, m.","020301",57476,29513,29508,29202,15028,14174
"dolnośląskie","głogowski","Jerzmanowa, gm.","020303",2341,1084,1084,1074,592,482
"dolnośląskie","głogowski","Kotla, gm.","020304",3114,1286,1286,1273,743,530
"dolnośląskie","głogowski","Pęcław, gm.","020305",1757,732,732,725,464,261
"dolnośląskie","głogowski","Żukowice, gm.","020306",2707,970,970,958,562,396
"dolnośląskie","górowski","Góra, gm.","020401",16340,6982,6981,6896,3725,3171
"dolnośląskie","górowski","Jemielno, gm.","020402",2439,894,894,884,546,338
"dolnośląskie","górowski","Niechlów, gm.","020403",3923,1475,1473,1453,964,489
"dolnośląskie","górowski","Wąsosz, gm.","020404",5815,2175,2175,2154,1251,903
"dolnośląskie","jaworski","Bolków, gm.","020502",8965,3687,3687,3646,1798,1848
"dolnośląskie","jaworski","Jawor, m.","020501",20234,9563,9558,9476,4660,4816
"dolnośląskie","jaworski","Męcinka, gm.","020503",3753,1507,1506,1496,1002,494
"dolnośląskie","jaworski","Mściwojów, gm.","020504",3254,1352,1352,1325,792,533
"dolnośląskie","jaworski","Paszowice, gm.","020505",3099,1187,1187,1181,748,433
"dolnośląskie","jaworski","Wądroże Wielkie, gm.","020506",3207,1047,1047,1039,664,375
"dolnośląskie","jeleniogórski","Janowice Wielkie, gm.","020605",3472,1530,1529,1501,543,958
"dolnośląskie","jeleniogórski","Jeżów Sudecki, gm.","020606",4836,2277,2276,2257,923,1334
"dolnośląskie","jeleniogórski","Karpacz, m.","020601",4503,2196,2194,2177,597,1580
"dolnośląskie","jeleniogórski","Kowary, m.","020602",10039,4466,4466,4413,1691,2722
"dolnośląskie","jeleniogórski","Mysłakowice, gm.","020607",8003,3728,3728,3697,1391,2306
"dolnośląskie","jeleniogórski","Piechowice, m.","020603",5454,2551,2551,2521,979,1542
"dolnośląskie","jeleniogórski","Podgórzyn, gm.","020608",6446,2994,2994,2970,1096,1874
"dolnośląskie","jeleniogórski","Stara Kamienica, gm.","020609",4073,1691,1690,1679,678,1001
"dolnośląskie","jeleniogórski","Szklarska Poręba, m.","020604",6288,3050,3049,3017,1073,1944
"dolnośląskie","kamiennogórski","Kamienna Góra, gm.","020702",6606,3002,2998,2958,1497,1461
"dolnośląskie","kamiennogórski","Kamienna Góra, m.","020701",17993,8320,8320,8243,3756,4487
"dolnośląskie","kamiennogórski","Lubawka, gm.","020703",9514,4143,4141,4094,1687,2407
"dolnośląskie","kamiennogórski","Marciszów, gm.","020704",3771,1643,1643,1631,774,857
"dolnośląskie","kłodzki","Bystrzyca Kłodzka, gm.","020806",16711,7674,7672,7586,3886,3700
"dolnośląskie","kłodzki","Duszniki-Zdrój, m.","020801",4532,2205,2205,2186,842,1344
"dolnośląskie","kłodzki","Kłodzko, gm.","020807",13665,5958,5958,5885,3119,2766
"dolnośląskie","kłodzki","Kłodzko, m.","020802",25043,12405,12401,12277,5413,6864
"dolnośląskie","kłodzki","Kudowa-Zdrój, m.","020803",8625,4132,4129,4090,1819,2271
"dolnośląskie","kłodzki","Lądek-Zdrój, gm.","020808",7708,3449,3449,3403,1613,1790
"dolnośląskie","kłodzki","Lewin Kłodzki, gm.","020809",1607,660,660,658,318,340
"dolnośląskie","kłodzki","Międzylesie, gm.","020810",6225,2716,2716,2679,1283,1396
"dolnośląskie","kłodzki","Nowa Ruda, gm.","020811",10128,4165,4165,4125,1962,2163
"dolnośląskie","kłodzki","Nowa Ruda, m.","020804",20660,8902,8901,8812,4036,4776
"dolnośląskie","kłodzki","Polanica-Zdrój, m.","020805",5895,2955,2955,2928,1336,1592
"dolnośląskie","kłodzki","Radków, gm.","020812",7582,3197,3197,3170,1624,1546
"dolnośląskie","kłodzki","Stronie Śląskie, gm.","020813",6139,2572,2572,2545,1028,1517
"dolnośląskie","kłodzki","Szczytna, gm.","020814",6018,2637,2635,2604,1054,1550
"dolnośląskie","legnicki","Chojnów, gm.","020902",7229,2850,2850,2833,1790,1043
"dolnośląskie","legnicki","Chojnów, m.","020901",11668,5120,5118,5077,2474,2603
"dolnośląskie","legnicki","Krotoszyce, gm.","020903",2316,961,961,952,609,343
"dolnośląskie","legnicki","Kunice, gm.","020904",3944,1894,1894,1876,951,925
"dolnośląskie","legnicki","Legnickie Pole, gm.","020905",3836,1515,1515,1493,908,585
"dolnośląskie","legnicki","Miłkowice, gm.","020906",4910,2187,2187,2168,1141,1027
"dolnośląskie","legnicki","Prochowice, gm.","020907",5793,2580,2580,2571,1307,1264
"dolnośląskie","legnicki","Ruja, gm.","020908",2125,781,781,768,492,276
"dolnośląskie","lubański","Leśna, gm.","021003",8481,3528,3528,3492,1610,1882
"dolnośląskie","lubański","Lubań, gm.","021004",4983,2020,2020,1992,1051,941
"dolnośląskie","lubański","Lubań, m.","021001",18965,8757,8756,8678,3942,4736
"dolnośląskie","lubański","Olszyna, gm.","021005",5456,2234,2234,2208,951,1257
"dolnośląskie","lubański","Platerówka, gm.","021006",1304,561,561,554,328,226
"dolnośląskie","lubański","Siekierczyn, gm.","021007",4077,1958,1958,1944,1053,891
"dolnośląskie","lubański","Świeradów-Zdrój, m.","021002",3896,1841,1840,1817,762,1055
"dolnośląskie","lubiński","Lubin, gm.","021102",8307,3622,3620,3589,1921,1668
"dolnośląskie","lubiński","Lubin, m.","021101",63581,32535,32525,32285,17070,15215
"dolnośląskie","lubiński","Rudna, gm.","021103",5486,2259,2258,2232,1372,860
"dolnośląskie","lubiński","Ścinawa, gm.","021104",8368,3826,3826,3792,2409,1383
"dolnośląskie","lwówecki","Gryfów Śląski, gm.","021201",8308,3418,3411,3365,1588,1777
"dolnośląskie","lwówecki","Lubomierz, gm.","021202",4921,1951,1950,1919,925,994
"dolnośląskie","lwówecki","Lwówek Śląski, gm.","021203",14341,6084,6083,6033,2751,3282
"dolnośląskie","lwówecki","Mirsk, gm.","021204",7321,2768,2768,2739,1349,1390
"dolnośląskie","lwówecki","Wleń, gm.","021205",3806,1600,1600,1572,738,834
"dolnośląskie","milicki","Cieszków, gm.","021301",3641,1510,1510,1489,844,645
"dolnośląskie","milicki","Krośnice, gm.","021302",6220,2564,2564,2534,1495,1039
"dolnośląskie","milicki","Milicz, gm.","021303",19043,8916,8914,8792,4489,4303
"dolnośląskie","oleśnicki","Bierutów, gm.","021402",8096,3327,3327,3294,1700,1594
"dolnośląskie","oleśnicki","Dobroszyce, gm.","021403",4562,1874,1874,1863,1067,796
"dolnośląskie","oleśnicki","Dziadowa Kłoda, gm.","021404",3483,1290,1290,1276,733,543
"dolnośląskie","oleśnicki","Międzybórz, gm.","021405",3788,1596,1596,1575,657,918
"dolnośląskie","oleśnicki","Oleśnica, gm.","021406",8572,3215,3215,3188,1981,1207
"dolnośląskie","oleśnicki","Oleśnica, m.","021401",29877,15578,15577,15407,7257,8150
"dolnośląskie","oleśnicki","Syców, gm.","021407",12677,5937,5937,5887,2583,3304
"dolnośląskie","oleśnicki","Twardogóra, gm.","021408",9985,4093,4093,4059,1983,2076
"dolnośląskie","oławski","Domaniów, gm.","021502",4085,1916,1915,1903,1311,592
"dolnośląskie","oławski","Jelcz-Laskowice, gm.","021503",16960,8516,8516,8463,4815,3648
"dolnośląskie","oławski","Oława, gm.","021504",10282,5058,5058,5022,3066,1956
"dolnośląskie","oławski","Oława, m.","021501",25521,13875,13872,13759,6612,7147
"dolnośląskie","polkowicki","Chocianów, gm.","021601",9897,4747,4742,4707,2885,1822
"dolnośląskie","polkowicki","Gaworzyce, gm.","021602",2899,1439,1439,1414,869,545
"dolnośląskie","polkowicki","Grębocice, gm.","021603",4040,1665,1664,1649,1027,622
"dolnośląskie","polkowicki","Polkowice, gm.","021604",19945,9720,9721,9641,5603,4038
"dolnośląskie","polkowicki","Przemków, gm.","021605",7016,2866,2866,2842,1613,1229
"dolnośląskie","polkowicki","Radwanice, gm.","021606",3352,1382,1382,1369,776,593
"dolnośląskie","strzeliński","Borów, gm.","021701",4178,2047,2047,2039,1411,628
"dolnośląskie","strzeliński","Kondratowice, gm.","021702",3735,1562,1562,1550,860,690
"dolnośląskie","strzeliński","Przeworno, gm.","021703",4176,1772,1772,1756,1089,667
"dolnośląskie","strzeliński","Strzelin, gm.","021704",18411,8839,8839,8766,4252,4514
"dolnośląskie","strzeliński","Wiązów, gm.","021705",5899,2587,2587,2562,1798,764
"dolnośląskie","średzki","Kostomłoty, gm.","021801",5473,2150,2150,2137,1380,757
"dolnośląskie","średzki","Malczyce, gm.","021802",4684,1937,1937,1921,1150,771
"dolnośląskie","średzki","Miękinia, gm.","021803",8916,3954,3954,3906,2020,1886
"dolnośląskie","średzki","Środa Śląska, gm.","021804",15167,6516,6516,6463,3167,3296
"dolnośląskie","średzki","Udanin, gm.","021805",4432,1688,1688,1671,1086,585
"dolnośląskie","świdnicki","Dobromierz, gm.","021903",4346,1789,1789,1770,1161,609
"dolnośląskie","świdnicki","Jaworzyna Śląska, gm.","021904",8192,3563,3563,3528,1984,1544
"dolnośląskie","świdnicki","Marcinowice, gm.","021905",4966,2269,2267,2262,1341,921
"dolnośląskie","świdnicki","Strzegom, gm.","021906",22004,9896,9895,9806,4971,4835
"dolnośląskie","świdnicki","Świdnica, gm.","021907",12234,5503,5503,5440,3007,2433
"dolnośląskie","świdnicki","Świdnica, m.","021901",50149,26275,26270,25996,11586,14410
"dolnośląskie","świdnicki","Świebodzice, m.","021902",19098,8731,8730,8643,4200,4443
"dolnośląskie","świdnicki","Żarów, gm.","021908",9885,4302,4300,4245,2241,2004
"dolnośląskie","trzebnicki","Oborniki Śląskie, gm.","022001",14019,7069,7069,7004,3386,3618
"dolnośląskie","trzebnicki","Prusice, gm.","022002",7136,2777,2776,2741,1658,1083
"dolnośląskie","trzebnicki","Trzebnica, gm.","022003",17284,7996,7995,7926,4029,3897
"dolnośląskie","trzebnicki","Wisznia Mała, gm.","022004",6180,3167,3167,3145,1775,1370
"dolnośląskie","trzebnicki","Zawonia, gm.","022005",4141,1605,1605,1591,846,745
"dolnośląskie","trzebnicki","Żmigród, gm.","022006",11660,4749,4749,4712,2159,2553
"dolnośląskie","wałbrzyski","Boguszów-Gorce, m.","022101",13935,5808,5806,5734,2337,3397
"dolnośląskie","wałbrzyski","Czarny Bór, gm.","022104",3706,1824,1824,1803,838,965
"dolnośląskie","wałbrzyski","Głuszyca, gm.","022105",7673,3302,3301,3269,1279,1990
"dolnośląskie","wałbrzyski","Jedlina-Zdrój, m.","022102",4205,1951,1950,1930,722,1208
"dolnośląskie","wałbrzyski","Mieroszów, gm.","022106",6154,2375,2375,2358,910,1448
"dolnośląskie","wałbrzyski","Stare Bogaczowice, gm.","022107",3289,1466,1466,1443,688,755
"dolnośląskie","wałbrzyski","Szczawno-Zdrój, m.","022103",4955,2596,2594,2559,1000,1559
"dolnośląskie","wałbrzyski","Walim, gm.","022108",4707,1909,1909,1889,971,918
"dolnośląskie","wałbrzyski","Wałbrzych, m.","022109",105074,48081,48071,47531,20078,27453
"dolnośląskie","wołowski","Brzeg Dolny, gm.","022201",13208,6435,6434,6367,2860,3507
"dolnośląskie","wołowski","Wińsko, gm.","022202",6909,2785,2785,2758,1880,878
"dolnośląskie","wołowski","Wołów, gm.","022203",19477,9310,9308,9219,4461,4758
"dolnośląskie","wrocławski","Czernica, gm.","022301",6572,3726,3724,3696,1943,1753
"dolnośląskie","wrocławski","Długołęka, gm.","022302",15038,7780,7780,7712,4295,3417
"dolnośląskie","wrocławski","Jordanów Śląski, gm.","022303",2375,1165,1165,1161,807,354
"dolnośląskie","wrocławski","Kąty Wrocławskie, gm.","022304",13910,6839,6839,6785,3565,3220
"dolnośląskie","wrocławski","Kobierzyce, gm.","022305",10057,5044,5041,5011,2520,2491
"dolnośląskie","wrocławski","Mietków, gm.","022306",3037,1371,1371,1352,792,560
"dolnośląskie","wrocławski","Sobótka, gm.","022307",9743,4423,4422,4373,2229,2144
"dolnośląskie","wrocławski","Święta Katarzyna, gm.","022308",10397,5811,5811,5774,3159,2615
"dolnośląskie","wrocławski","Żórawina, gm.","022309",6278,2757,2755,2733,1482,1251
"dolnośląskie","ząbkowicki","Bardo, gm.","022401",4496,2041,2041,2007,983,1024
"dolnośląskie","ząbkowicki","Ciepłowody, gm.","022402",2549,951,951,942,525,417
"dolnośląskie","ząbkowicki","Kamieniec Ząbkowicki, gm.","022403",6894,2963,2963,2918,1591,1327
"dolnośląskie","ząbkowicki","Stoszowice, gm.","022404",4441,1934,1934,1918,1060,858
"dolnośląskie","ząbkowicki","Ząbkowice Śląskie, gm.","022405",18903,9017,9004,8920,4411,4509
"dolnośląskie","ząbkowicki","Ziębice, gm.","022406",14890,6429,6429,6384,3578,2806
"dolnośląskie","ząbkowicki","Złoty Stok, gm.","022407",3950,1712,1712,1685,816,869
"dolnośląskie","zgorzelecki","Bogatynia, gm.","022503",20115,9507,9506,9414,4348,5066
"dolnośląskie","zgorzelecki","Pieńsk, gm.","022504",7393,2960,2959,2922,1106,1816
"dolnośląskie","zgorzelecki","Sulików, gm.","022505",4667,1932,1932,1915,1092,823
"dolnośląskie","zgorzelecki","Węgliniec, gm.","022506",7195,3025,3025,2989,1194,1795
"dolnośląskie","zgorzelecki","Zawidów, m.","022501",3519,1634,1633,1617,759,858
"dolnośląskie","zgorzelecki","Zgorzelec, gm.","022507",6066,2520,2520,2501,1191,1310
"dolnośląskie","zgorzelecki","Zgorzelec, m.","022502",27985,13767,13761,13626,5764,7862
"dolnośląskie","złotoryjski","Pielgrzymka, gm.","022603",3666,1562,1562,1540,888,652
"dolnośląskie","złotoryjski","Świerzawa, gm.","022604",6272,2536,2536,2519,1207,1312
"dolnośląskie","złotoryjski","Wojcieszów, m.","022601",3197,1247,1247,1229,510,719
"dolnośląskie","złotoryjski","Zagrodno, gm.","022605",4512,2013,2013,2002,1339,663
"dolnośląskie","złotoryjski","Złotoryja, gm.","022606",5479,2277,2277,2251,1221,1030
"dolnośląskie","złotoryjski","Złotoryja, m.","022602",13864,6385,6384,6310,2881,3429
"dolnośląskie","Jelenia Góra","Jelenia Góra, m.","026101",71398,37203,37194,36795,13986,22809
"dolnośląskie","Legnica","Legnica, m.","026201",83525,41667,41656,41303,19344,21959
"dolnośląskie","Wrocław","Wrocław, m.","026401",514697,305613,305456,302743,124894,177849
"kujawsko-pomorskie","aleksandrowski","Aleksandrów Kujawski, gm.","040104",8053,2959,2959,2915,1846,1069
"kujawsko-pomorskie","aleksandrowski","Aleksandrów Kujawski, m.","040101",10090,4377,4377,4327,2107,2220
"kujawsko-pomorskie","aleksandrowski","Bądkowo, gm.","040105",3688,1299,1299,1275,905,370
"kujawsko-pomorskie","aleksandrowski","Ciechocinek, m.","040102",9916,5718,5710,5645,2869,2776
"kujawsko-pomorskie","aleksandrowski","Koneck, gm.","040106",2655,916,916,901,655,246
"kujawsko-pomorskie","aleksandrowski","Nieszawa, m.","040103",1638,850,850,834,461,373
"kujawsko-pomorskie","aleksandrowski","Raciążek, gm.","040107",2312,967,967,946,595,351
"kujawsko-pomorskie","aleksandrowski","Waganiec, gm.","040108",3445,1362,1362,1347,957,390
"kujawsko-pomorskie","aleksandrowski","Zakrzewo, gm.","040109",2968,1054,1053,1029,681,348
"kujawsko-pomorskie","brodnicki","Bartniczka, gm.","040206",3504,1621,1621,1604,1069,535
"kujawsko-pomorskie","brodnicki","Bobrowo, gm.","040202",4907,1876,1876,1851,1270,581
"kujawsko-pomorskie","brodnicki","Brodnica, gm.","040203",4764,1837,1837,1816,1195,621
"kujawsko-pomorskie","brodnicki","Brodnica, m.","040201",21595,10498,10497,10392,5517,4875
"kujawsko-pomorskie","brodnicki","Brzozie, gm.","040204",2787,1307,1307,1296,957,339
"kujawsko-pomorskie","brodnicki","Górzno, gm.","040205",3002,1315,1315,1301,930,371
"kujawsko-pomorskie","brodnicki","Jabłonowo Pomorskie, gm.","040207",7045,2920,2920,2888,1876,1012
"kujawsko-pomorskie","brodnicki","Osiek, gm.","040208",3175,1235,1235,1226,935,291
"kujawsko-pomorskie","brodnicki","Świedziebnia, gm.","040209",3873,1528,1528,1512,1213,299
"kujawsko-pomorskie","brodnicki","Zbiczno, gm.","040210",3563,1468,1468,1449,875,574
"kujawsko-pomorskie","bydgoski","Białe Błota, gm.","040301",9857,5113,5113,5062,2392,2670
"kujawsko-pomorskie","bydgoski","Dąbrowa Chełmińska, gm.","040302",5261,2062,2062,2036,1154,882
"kujawsko-pomorskie","bydgoski","Dobrcz, gm.","040303",6954,2979,2979,2936,1765,1171
"kujawsko-pomorskie","bydgoski","Koronowo, gm.","040304",18149,7585,7584,7480,4366,3114
"kujawsko-pomorskie","bydgoski","Nowa Wieś Wielka, gm.","040305",5933,2436,2436,2416,1207,1209
"kujawsko-pomorskie","bydgoski","Osielsko, gm.","040306",6159,3452,3452,3418,1588,1830
"kujawsko-pomorskie","bydgoski","Sicienko, gm.","040307",6797,2971,2971,2937,1490,1447
"kujawsko-pomorskie","bydgoski","Solec Kujawski, gm.","040308",12289,5881,5879,5819,2806,3013
"kujawsko-pomorskie","chełmiński","Chełmno, gm.","040402",3858,1248,1248,1234,752,482
"kujawsko-pomorskie","chełmiński","Chełmno, m.","040401",16670,7405,7405,7298,3470,3828
"kujawsko-pomorskie","chełmiński","Kijewo Królewskie, gm.","040403",3319,1408,1407,1389,893,496
"kujawsko-pomorskie","chełmiński","Lisewo, gm.","040404",4023,1406,1406,1391,843,548
"kujawsko-pomorskie","chełmiński","Papowo Biskupie, gm.","040405",3311,1207,1207,1186,789,397
"kujawsko-pomorskie","chełmiński","Stolno, gm.","040406",3836,1265,1265,1258,769,489
"kujawsko-pomorskie","chełmiński","Unisław, gm.","040407",5200,2153,2153,2119,1201,918
"kujawsko-pomorskie","golubsko-dobrzyński","Ciechocin, gm.","040502",2937,1261,1261,1254,990,264
"kujawsko-pomorskie","golubsko-dobrzyński","Golub-Dobrzyń, gm.","040503",6259,2295,2294,2262,1518,744
"kujawsko-pomorskie","golubsko-dobrzyński","Golub-Dobrzyń, m.","040501",9970,4513,4510,4453,2464,1989
"kujawsko-pomorskie","golubsko-dobrzyński","Kowalewo Pomorskie, gm.","040504",8662,3687,3687,3643,2274,1369
"kujawsko-pomorskie","golubsko-dobrzyński","Radomin, gm.","040505",3139,1192,1192,1184,985,199
"kujawsko-pomorskie","golubsko-dobrzyński","Zbójno, gm.","040506",3368,1158,1158,1142,877,265
"kujawsko-pomorskie","grudziądzki","Grudziądz, gm.","040601",7914,3013,3013,2984,1570,1414
"kujawsko-pomorskie","grudziądzki","Gruta, gm.","040602",5072,1944,1944,1920,1211,709
"kujawsko-pomorskie","grudziądzki","Łasin, gm.","040603",6517,2497,2497,2475,1462,1013
"kujawsko-pomorskie","grudziądzki","Radzyń Chełmiński, gm.","040604",3705,1332,1332,1312,892,420
"kujawsko-pomorskie","grudziądzki","Rogóźno, gm.","040605",3099,1106,1106,1103,733,370
"kujawsko-pomorskie","grudziądzki","Świecie nad Osą, gm.","040606",3388,1078,1078,1066,693,373
"kujawsko-pomorskie","inowrocławski","Dąbrowa Biskupia, gm.","040702",4040,1203,1203,1176,776,400
"kujawsko-pomorskie","inowrocławski","Gniewkowo, gm.","040703",11571,4264,4263,4196,2208,1988
"kujawsko-pomorskie","inowrocławski","Inowrocław, gm.","040704",8512,3134,3133,3082,1830,1252
"kujawsko-pomorskie","inowrocławski","Inowrocław, m.","040701",63133,29918,29914,29417,13299,16118
"kujawsko-pomorskie","inowrocławski","Janikowo, gm.","040705",10659,4299,4299,4252,2296,1956
"kujawsko-pomorskie","inowrocławski","Kruszwica, gm.","040706",15937,6091,6090,5989,3498,2491
"kujawsko-pomorskie","inowrocławski","Pakość, gm.","040707",7910,3054,3054,3004,1519,1485
"kujawsko-pomorskie","inowrocławski","Rojewo, gm.","040708",3502,1428,1428,1409,961,448
"kujawsko-pomorskie","inowrocławski","Złotniki Kujawskie, gm.","040709",6899,2508,2508,2465,1425,1040
"kujawsko-pomorskie","lipnowski","Bobrowniki, gm.","040802",2280,768,768,753,486,267
"kujawsko-pomorskie","lipnowski","Chrostkowo, gm.","040803",2430,825,825,818,662,156
"kujawsko-pomorskie","lipnowski","Dobrzyń nad Wisłą, gm.","040804",6243,2222,2222,2188,1528,660
"kujawsko-pomorskie","lipnowski","Kikół, gm.","040805",5495,1880,1880,1863,1250,613
"kujawsko-pomorskie","lipnowski","Lipno, gm.","040806",8562,2896,2895,2863,2079,784
"kujawsko-pomorskie","lipnowski","Lipno, m.","040801",11628,5332,5331,5234,3111,2123
"kujawsko-pomorskie","lipnowski","Skępe, gm.","040807",5881,2344,2344,2316,1341,975
"kujawsko-pomorskie","lipnowski","Tłuchowo, gm.","040808",3567,1333,1333,1310,1023,287
"kujawsko-pomorskie","lipnowski","Wielgie, gm.","040809",5038,1735,1734,1708,1182,526
"kujawsko-pomorskie","mogileński","Dąbrowa, gm.","040901",3593,1330,1330,1308,849,459
"kujawsko-pomorskie","mogileński","Jeziora Wielkie, gm.","040902",3898,1327,1327,1305,903,402
"kujawsko-pomorskie","mogileński","Mogilno, gm.","040903",19465,8844,8844,8719,5400,3319
"kujawsko-pomorskie","mogileński","Strzelno, gm.","040904",9613,3938,3938,3864,2208,1656
"kujawsko-pomorskie","nakielski","Kcynia, gm.","041001",10524,4273,4273,4219,2336,1883
"kujawsko-pomorskie","nakielski","Mrocza, gm.","041002",6799,2708,2708,2690,1462,1228
"kujawsko-pomorskie","nakielski","Nakło nad Notecią, gm.","041003",26365,12780,12776,12637,5862,6775
"kujawsko-pomorskie","nakielski","Sadki, gm.","041004",5387,2414,2414,2404,1396,1008
"kujawsko-pomorskie","nakielski","Szubin, gm.","041005",17296,7715,7715,7633,3893,3740
"kujawsko-pomorskie","radziejowski","Bytoń, gm.","041102",3043,1076,1076,1052,835,217
"kujawsko-pomorskie","radziejowski","Dobre, gm.","041103",4423,1453,1453,1440,974,466
"kujawsko-pomorskie","radziejowski","Osięciny, gm.","041104",6533,2171,2171,2135,1504,631
"kujawsko-pomorskie","radziejowski","Piotrków Kujawski, gm.","041105",7652,2808,2808,2754,1886,868
"kujawsko-pomorskie","radziejowski","Radziejów, gm.","041106",3487,1158,1158,1137,819,318
"kujawsko-pomorskie","radziejowski","Radziejów, m.","041101",5004,2154,2154,2114,1152,962
"kujawsko-pomorskie","radziejowski","Topólka, gm.","041107",4078,1477,1477,1452,1071,381
"kujawsko-pomorskie","rypiński","Brzuze, gm.","041202",4225,1401,1400,1391,946,445
"kujawsko-pomorskie","rypiński","Rogowo, gm.","041203",3784,1364,1364,1349,1039,310
"kujawsko-pomorskie","rypiński","Rypin, gm.","041204",5700,1812,1812,1800,1237,563
"kujawsko-pomorskie","rypiński","Rypin, m.","041201",13116,6113,6113,6036,3325,2711
"kujawsko-pomorskie","rypiński","Skrwilno, gm.","041205",4882,1928,1928,1910,1520,390
"kujawsko-pomorskie","rypiński","Wąpielsk, gm.","041206",3278,1004,1004,994,689,305
"kujawsko-pomorskie","sępoleński","Kamień Krajeński, gm.","041301",5279,2068,2068,2042,1228,814
"kujawsko-pomorskie","sępoleński","Sępólno Krajeńskie, gm.","041302",12305,5234,5233,5165,2665,2500
"kujawsko-pomorskie","sępoleński","Sośno, gm.","041303",3944,1433,1433,1409,864,545
"kujawsko-pomorskie","sępoleński","Więcbork, gm.","041304",10192,4453,4450,4399,2581,1818
"kujawsko-pomorskie","świecki","Bukowiec, gm.","041401",3890,1482,1482,1461,935,526
"kujawsko-pomorskie","świecki","Dragacz, gm.","041402",5428,1984,1984,1957,986,971
"kujawsko-pomorskie","świecki","Drzycim, gm.","041403",3840,1527,1527,1513,901,612
"kujawsko-pomorskie","świecki","Jeżewo, gm.","041404",5876,2502,2501,2476,1339,1137
"kujawsko-pomorskie","świecki","Lniano, gm.","041405",3093,1377,1377,1354,846,508
"kujawsko-pomorskie","świecki","Nowe, gm.","041406",8573,3408,3408,3372,1537,1835
"kujawsko-pomorskie","świecki","Osie, gm.","041407",4005,1639,1639,1613,838,775
"kujawsko-pomorskie","świecki","Pruszcz, gm.","041408",7177,3177,3176,3133,1906,1227
"kujawsko-pomorskie","świecki","Świecie, gm.","041409",27015,12355,12354,12235,5466,6769
"kujawsko-pomorskie","świecki","Świekatowo, gm.","041410",2638,1139,1139,1120,744,376
"kujawsko-pomorskie","świecki","Warlubie, gm.","041411",4992,1807,1807,1787,1037,750
"kujawsko-pomorskie","toruński","Chełmża, gm.","041502",7246,2688,2688,2650,1802,848
"kujawsko-pomorskie","toruński","Chełmża, m.","041501",11860,4985,4985,4949,2545,2404
"kujawsko-pomorskie","toruński","Czernikowo, gm.","041503",6297,2195,2195,2180,1385,795
"kujawsko-pomorskie","toruński","Lubicz, gm.","041504",11872,5763,5763,5718,3430,2288
"kujawsko-pomorskie","toruński","Łubianka, gm.","041505",4211,1942,1942,1921,1282,639
"kujawsko-pomorskie","toruński","Łysomice, gm.","041506",6202,2554,2554,2528,1546,982
"kujawsko-pomorskie","toruński","Obrowo, gm.","041507",7043,3129,3129,3108,2235,873
"kujawsko-pomorskie","toruński","Wielka Nieszawka, gm.","041508",2995,1404,1404,1392,733,659
"kujawsko-pomorskie","toruński","Zławieś Wielka, gm.","041509",8244,3498,3497,3470,1968,1502
"kujawsko-pomorskie","tucholski","Cekcyn, gm.","041601",4938,2138,2137,2128,1189,939
"kujawsko-pomorskie","tucholski","Gostycyn, gm.","041602",4030,1739,1739,1701,1154,547
"kujawsko-pomorskie","tucholski","Kęsowo, gm.","041603",3342,1364,1364,1345,900,445
"kujawsko-pomorskie","tucholski","Lubiewo, gm.","041604",4308,2003,2003,1986,1299,687
"kujawsko-pomorskie","tucholski","Śliwice, gm.","041605",4097,1970,1969,1946,1083,863
"kujawsko-pomorskie","tucholski","Tuchola, gm.","041606",15352,7458,7458,7336,3996,3340
"kujawsko-pomorskie","wąbrzeski","Dębowa Łąka, gm.","041702",2420,912,911,899,576,323
"kujawsko-pomorskie","wąbrzeski","Książki, gm.","041703",3405,1343,1343,1328,751,577
"kujawsko-pomorskie","wąbrzeski","Płużnica, gm.","041704",3889,1367,1367,1351,866,485
"kujawsko-pomorskie","wąbrzeski","Wąbrzeźno, gm.","041705",6520,2236,2236,2202,1443,759
"kujawsko-pomorskie","wąbrzeski","Wąbrzeźno, m.","041701",11181,4976,4976,4892,2001,2891
"kujawsko-pomorskie","włocławski","Baruchowo, gm.","041802",2778,914,914,899,568,331
"kujawsko-pomorskie","włocławski","Boniewo, gm.","041803",2829,876,876,864,616,248
"kujawsko-pomorskie","włocławski","Brześć Kujawski, gm.","041804",8831,3023,3020,2975,1700,1275
"kujawsko-pomorskie","włocławski","Choceń, gm.","041805",6430,1899,1899,1876,1242,634
"kujawsko-pomorskie","włocławski","Chodecz, gm.","041806",5122,1851,1851,1832,1256,576
"kujawsko-pomorskie","włocławski","Fabianki, gm.","041807",6477,2261,2261,2236,1137,1099
"kujawsko-pomorskie","włocławski","Izbica Kujawska, gm.","041808",6219,2337,2337,2310,1781,529
"kujawsko-pomorskie","włocławski","Kowal, gm.","041809",3212,1088,1088,1065,759,306
"kujawsko-pomorskie","włocławski","Kowal, m.","041801",2753,1191,1191,1165,671,494
"kujawsko-pomorskie","włocławski","Lubanie, gm.","041810",3653,1384,1384,1362,956,406
"kujawsko-pomorskie","włocławski","Lubień Kujawski, gm.","041811",6109,2184,2184,2156,1584,572
"kujawsko-pomorskie","włocławski","Lubraniec, gm.","041812",8064,3112,3112,3060,2154,906
"kujawsko-pomorskie","włocławski","Włocławek, gm.","041813",5074,1751,1751,1727,1013,714
"kujawsko-pomorskie","żniński","Barcin, gm.","041901",11736,4782,4780,4706,2160,2546
"kujawsko-pomorskie","żniński","Gąsawa, gm.","041902",4045,1803,1803,1765,1116,649
"kujawsko-pomorskie","żniński","Janowiec Wielkopolski, gm.","041903",7478,2962,2961,2886,1588,1298
"kujawsko-pomorskie","żniński","Łabiszyn, gm.","041904",7100,2965,2965,2923,1672,1251
"kujawsko-pomorskie","żniński","Rogowo, gm.","041905",5291,2348,2344,2298,1394,904
"kujawsko-pomorskie","żniński","Żnin, gm.","041906",19183,8900,8900,8725,5017,3708
"kujawsko-pomorskie","Bydgoszcz","Bydgoszcz, m.","046101",297177,166404,166362,164255,77962,86293
"kujawsko-pomorskie","Grudziądz","Grudziądz, m.","046201",80240,37039,37035,36631,15718,20913
"kujawsko-pomorskie","Toruń","Toruń, m.","046301",164000,93042,93014,92138,42984,49154
"kujawsko-pomorskie","Włocławek","Włocławek, m.","046401",96872,47018,47007,46393,21837,24556
"lubelskie","bialski","Biała Podlaska, gm.","060103",9004,4346,4337,4303,3229,1074
"lubelskie","bialski","Drelów, gm.","060104",4301,1948,1948,1929,1528,401
"lubelskie","bialski","Janów Podlaski, gm.","060105",4389,1914,1914,1896,1359,537
"lubelskie","bialski","Kodeń, gm.","060106",3338,1379,1379,1357,834,523
"lubelskie","bialski","Konstantynów, gm.","060107",3152,1491,1491,1471,1089,382
"lubelskie","bialski","Leśna Podlaska, gm.","060108",3374,1658,1658,1646,1295,351
"lubelskie","bialski","Łomazy, gm.","060109",4260,2243,2243,2223,1872,351
"lubelskie","bialski","Międzyrzec Podlaski, gm.","060110",7699,4002,4002,3977,3435,542
"lubelskie","bialski","Międzyrzec Podlaski, m.","060101",13632,7239,7229,7158,4877,2281
"lubelskie","bialski","Piszczac, gm.","060111",5800,2459,2459,2441,1693,748
"lubelskie","bialski","Rokitno, gm.","060112",2609,1125,1125,1118,877,241
"lubelskie","bialski","Rossosz, gm.","060113",1902,1030,1029,1019,885,134
"lubelskie","bialski","Sławatycze, gm.","060114",2162,1019,1019,1009,627,382
"lubelskie","bialski","Sosnówka, gm.","060115",2338,899,899,894,738,156
"lubelskie","bialski","Terespol, gm.","060116",5573,2588,2588,2557,1779,778
"lubelskie","bialski","Terespol, m.","060102",4614,2288,2288,2265,1225,1040
"lubelskie","bialski","Tuczna, gm.","060117",2913,1146,1146,1134,897,237
"lubelskie","bialski","Wisznice, gm.","060118",4255,2019,2019,2005,1543,462
"lubelskie","bialski","Zalesie, gm.","060119",3461,1606,1604,1584,1205,379
"lubelskie","biłgorajski","Aleksandrów, gm.","060202",2390,1306,1306,1302,1122,180
"lubelskie","biłgorajski","Biłgoraj, gm.","060203",9566,5018,5018,4976,4122,854
"lubelskie","biłgorajski","Biłgoraj, m.","060201",21282,11056,11055,10954,7107,3847
"lubelskie","biłgorajski","Biszcza, gm.","060204",3128,1490,1490,1471,1273,198
"lubelskie","biłgorajski","Frampol, gm.","060205",5169,2510,2510,2492,2128,364
"lubelskie","biłgorajski","Goraj, gm.","060206",3571,1781,1781,1761,1591,170
"lubelskie","biłgorajski","Józefów, gm.","060207",5825,2441,2441,2418,1562,856
"lubelskie","biłgorajski","Księżpol, gm.","060208",5101,2251,2251,2231,1862,369
"lubelskie","biłgorajski","Łukowa, gm.","060209",3404,1789,1789,1775,1586,189
"lubelskie","biłgorajski","Obsza, gm.","060210",3424,1708,1708,1696,1478,218
"lubelskie","biłgorajski","Potok Górny, gm.","060211",4386,2323,2321,2309,2103,206
"lubelskie","biłgorajski","Tarnogród, gm.","060212",5514,2828,2828,2809,2285,524
"lubelskie","biłgorajski","Tereszpol, gm.","060213",3123,1470,1469,1457,1192,265
"lubelskie","biłgorajski","Turobin, gm.","060214",5966,2953,2953,2942,2664,278
"lubelskie","chełmski","Białopole, gm.","060302",2686,1027,1027,1018,778,240
"lubelskie","chełmski","Chełm, gm.","060303",9790,4240,4240,4211,3170,1041
"lubelskie","chełmski","Dorohusk, gm.","060304",5667,2286,2286,2264,1620,644
"lubelskie","chełmski","Dubienka, gm.","060305",2244,860,860,856,577,279
"lubelskie","chełmski","Kamień, gm.","060306",3098,1349,1349,1342,1097,245
"lubelskie","chełmski","Leśniowice, gm.","060307",3183,1171,1171,1155,884,271
"lubelskie","chełmski","Rejowiec Fabryczny, gm.","060308",3611,1385,1385,1363,1028,335
"lubelskie","chełmski","Rejowiec Fabryczny, m.","060301",3650,1486,1486,1473,917,556
"lubelskie","chełmski","Ruda-Huta, gm.","060309",3810,1515,1515,1501,996,505
"lubelskie","chełmski","Sawin, gm.","060310",4622,1844,1844,1830,1331,499
"lubelskie","chełmski","Siedliszcze, gm.","060311",5647,2002,2002,1975,1431,544
"lubelskie","chełmski","Wierzbica, gm.","060312",4225,1778,1778,1755,1405,350
"lubelskie","chełmski","Wojsławice, gm.","060313",3457,1467,1467,1459,1173,286
"lubelskie","chełmski","Żmudź, gm.","060314",2662,1046,1046,1036,850,186
"lubelskie","hrubieszowski","Dołhobyczów, gm.","060402",5302,2168,2168,2149,1723,426
"lubelskie","hrubieszowski","Horodło, gm.","060403",4770,1631,1631,1612,1151,461
"lubelskie","hrubieszowski","Hrubieszów, gm.","060404",8686,3410,3410,3390,2735,655
"lubelskie","hrubieszowski","Hrubieszów, m.","060401",15888,7738,7737,7666,4661,3005
"lubelskie","hrubieszowski","Mircze, gm.","060405",6536,2529,2529,2508,2093,415
"lubelskie","hrubieszowski","Trzeszczany, gm.","060406",3975,1552,1552,1536,1229,307
"lubelskie","hrubieszowski","Uchanie, gm.","060407",4247,1905,1905,1882,1625,257
"lubelskie","hrubieszowski","Werbkowice, gm.","060408",8305,3659,3659,3623,2906,717
"lubelskie","janowski","Batorz, gm.","060501",2832,1580,1580,1567,1453,114
"lubelskie","janowski","Chrzanów, gm.","060502",2573,1784,1783,1773,1715,58
"lubelskie","janowski","Dzwola, gm.","060503",5330,3193,3192,3177,2997,180
"lubelskie","janowski","Godziszów, gm.","060504",4907,3682,3682,3666,3527,139
"lubelskie","janowski","Janów Lubelski, gm.","060505",12906,7272,7268,7222,5707,1515
"lubelskie","janowski","Modliborzyce, gm.","060506",5839,3038,3038,3011,2610,401
"lubelskie","janowski","Potok Wielki, gm.","060507",3805,1815,1815,1797,1589,208
"lubelskie","krasnostawski","Fajsławice, gm.","060602",4056,2116,2116,2102,1781,321
"lubelskie","krasnostawski","Gorzków, gm.","060603",3392,1331,1330,1315,1100,215
"lubelskie","krasnostawski","Izbica, gm.","060604",7294,3009,3009,2985,2318,667
"lubelskie","krasnostawski","Krasnystaw, gm.","060605",7410,3087,3087,3063,2313,750
"lubelskie","krasnostawski","Krasnystaw, m.","060601",16709,7763,7762,7664,4327,3337
"lubelskie","krasnostawski","Kraśniczyn, gm.","060606",3647,1509,1509,1477,1206,271
"lubelskie","krasnostawski","Łopiennik Górny, gm.","060607",3497,1506,1506,1492,1257,235
"lubelskie","krasnostawski","Rejowiec, gm.","060608",5491,1960,1960,1946,1366,580
"lubelskie","krasnostawski","Rudnik, gm.","060609",2968,1170,1170,1158,1044,114
"lubelskie","krasnostawski","Siennica Różana, gm.","060610",3451,1508,1508,1487,1186,301
"lubelskie","krasnostawski","Żółkiewka, gm.","060611",5122,2086,2086,2065,1787,278
"lubelskie","kraśnicki","Annopol, gm.","060702",7336,3363,3363,3327,2646,681
"lubelskie","kraśnicki","Dzierzkowice, gm.","060703",4204,2243,2243,2232,1903,329
"lubelskie","kraśnicki","Gościeradów, gm.","060704",5751,2497,2496,2477,2113,364
"lubelskie","kraśnicki","Kraśnik, gm.","060705",5399,2752,2751,2738,2237,501
"lubelskie","kraśnicki","Kraśnik, m.","060701",30334,16373,16372,16162,10730,5432
"lubelskie","kraśnicki","Szastarka, gm.","060706",4919,2642,2642,2627,2339,288
"lubelskie","kraśnicki","Trzydnik Duży, gm.","060707",5491,2515,2515,2492,2044,448
"lubelskie","kraśnicki","Urzędów, gm.","060708",6950,3643,3643,3614,3099,515
"lubelskie","kraśnicki","Wilkołaz, gm.","060709",4342,2441,2436,2420,2184,236
"lubelskie","kraśnicki","Zakrzówek, gm.","060710",5644,2757,2757,2730,2356,374
"lubelskie","lubartowski","Abramów, gm.","060802",3479,1742,1741,1723,1554,169
"lubelskie","lubartowski","Firlej, gm.","060803",4819,1964,1964,1935,1464,471
"lubelskie","lubartowski","Jeziorzany, gm.","060804",2494,1088,1088,1077,878,199
"lubelskie","lubartowski","Kamionka, gm.","060805",5033,2339,2339,2303,1755,548
"lubelskie","lubartowski","Kock, gm.","060806",5426,2634,2634,2598,2019,579
"lubelskie","lubartowski","Lubartów, gm.","060807",7681,3625,3624,3589,2660,929
"lubelskie","lubartowski","Lubartów, m.","060801",18631,10319,10318,10209,5746,4463
"lubelskie","lubartowski","Michów, gm.","060808",5191,2318,2318,2296,1968,328
"lubelskie","lubartowski","Niedźwiada, gm.","060809",4945,2551,2551,2533,2145,388
"lubelskie","lubartowski","Ostrów Lubelski, gm.","060810",4384,2238,2237,2221,1868,353
"lubelskie","lubartowski","Ostrówek, gm.","060811",3353,1549,1549,1532,1263,269
"lubelskie","lubartowski","Serniki, gm.","060812",3741,2115,2115,2100,1801,299
"lubelskie","lubartowski","Uścimów, gm.","060813",2733,1331,1331,1314,1113,201
"lubelskie","lubelski","Bełżyce, gm.","060901",10625,5365,5365,5308,4251,1057
"lubelskie","lubelski","Borzechów, gm.","060902",3016,1613,1613,1598,1454,144
"lubelskie","lubelski","Bychawa, gm.","060903",9684,4610,4610,4578,3648,930
"lubelskie","lubelski","Garbów, gm.","060904",6837,3457,3456,3441,2722,719
"lubelskie","lubelski","Głusk, gm.","060905",5410,2901,2900,2878,2206,672
"lubelskie","lubelski","Jabłonna, gm.","060906",5935,2511,2510,2489,2100,389
"lubelskie","lubelski","Jastków, gm.","060907",8909,4862,4861,4840,3713,1127
"lubelskie","lubelski","Konopnica, gm.","060908",8340,4438,4438,4404,3210,1194
"lubelskie","lubelski","Krzczonów, gm.","060909",4136,1538,1538,1527,1287,240
"lubelskie","lubelski","Niedrzwica Duża, gm.","060910",8245,4659,4659,4624,3685,939
"lubelskie","lubelski","Niemce, gm.","060911",11971,6123,6116,6078,4686,1392
"lubelskie","lubelski","Strzyżewice, gm.","060912",5802,2763,2762,2721,2264,457
"lubelskie","lubelski","Wojciechów, gm.","060913",4642,2004,2004,1977,1622,355
"lubelskie","lubelski","Wólka, gm.","060914",6333,3490,3490,3451,2647,804
"lubelskie","lubelski","Wysokie, gm.","060915",4213,2014,2014,1989,1778,211
"lubelskie","lubelski","Zakrzew, gm.","060916",2713,1354,1354,1347,1218,129
"lubelskie","łęczyński","Cyców, gm.","061001",5703,2629,2629,2598,2050,548
"lubelskie","łęczyński","Ludwin, gm.","061002",3752,1622,1622,1608,1319,289
"lubelskie","łęczyński","Łęczna, gm.","061003",19030,10313,10312,10229,7302,2927
"lubelskie","łęczyński","Milejów, gm.","061004",7276,2940,2940,2906,2090,816
"lubelskie","łęczyński","Puchaczów, gm.","061005",3779,1785,1785,1773,1491,282
"lubelskie","łęczyński","Spiczyn, gm.","061006",4078,1854,1854,1843,1394,449
"lubelskie","łukowski","Adamów, gm.","061103",4643,2150,2150,2123,1560,563
"lubelskie","łukowski","Krzywda, gm.","061104",7874,3461,3460,3409,2736,673
"lubelskie","łukowski","Łuków, gm.","061105",12048,6097,6096,6042,5028,1014
"lubelskie","łukowski","Łuków, m.","061101",24367,13111,13102,12965,8445,4520
"lubelskie","łukowski","Serokomla, gm.","061106",3372,1471,1469,1465,1284,181
"lubelskie","łukowski","Stanin, gm.","061107",7443,3716,3715,3687,3111,576
"lubelskie","łukowski","Stoczek Łukowski, gm.","061108",6694,3252,3250,3212,2754,458
"lubelskie","łukowski","Stoczek Łukowski, m.","061102",2115,1147,1147,1134,742,392
"lubelskie","łukowski","Trzebieszów, gm.","061109",5678,3439,3438,3416,3038,378
"lubelskie","łukowski","Wojcieszków, gm.","061110",5463,2568,2568,2546,2057,489
"lubelskie","łukowski","Wola Mysłowska, gm.","061111",4131,1851,1851,1838,1565,273
"lubelskie","opolski","Chodel, gm.","061201",5155,2582,2582,2570,2196,374
"lubelskie","opolski","Józefów nad Wisłą, gm.","061202",5787,2186,2186,2160,1745,415
"lubelskie","opolski","Karczmiska, gm.","061203",4834,1901,1901,1878,1417,461
"lubelskie","opolski","Łaziska, gm.","061204",4296,1735,1735,1717,1466,251
"lubelskie","opolski","Opole Lubelskie, gm.","061205",14409,6292,6292,6213,4700,1513
"lubelskie","opolski","Poniatowa, gm.","061206",12624,5996,5996,5920,4193,1727
"lubelskie","opolski","Wilków, gm.","061207",3966,1861,1861,1847,1570,277
"lubelskie","parczewski","Dębowa Kłoda, gm.","061301",3263,1430,1430,1414,1101,313
"lubelskie","parczewski","Jabłoń, gm.","061302",3295,1841,1839,1818,1499,319
"lubelskie","parczewski","Milanów, gm.","061303",3290,1457,1456,1445,1124,321
"lubelskie","parczewski","Parczew, gm.","061304",12141,5710,5710,5664,3861,1803
"lubelskie","parczewski","Podedwórze, gm.","061305",1579,714,714,706,592,114
"lubelskie","parczewski","Siemień, gm.","061306",3980,1842,1842,1827,1481,346
"lubelskie","parczewski","Sosnowica, gm.","061307",2196,920,920,913,664,249
"lubelskie","puławski","Baranów, gm.","061402",3361,1480,1480,1465,1087,378
"lubelskie","puławski","Janowiec, gm.","061403",2860,1288,1288,1273,921,352
"lubelskie","puławski","Kazimierz Dolny, gm.","061404",5867,2817,2817,2793,1802,991
"lubelskie","puławski","Końskowola, gm.","061405",7161,3490,3490,3460,2589,871
"lubelskie","puławski","Kurów, gm.","061406",6316,2898,2898,2876,2284,592
"lubelskie","puławski","Markuszów, gm.","061407",2384,1186,1186,1172,961,211
"lubelskie","puławski","Nałęczów, gm.","061408",8051,4341,4341,4300,2950,1350
"lubelskie","puławski","Puławy, gm.","061409",8843,4058,4058,4005,2846,1159
"lubelskie","puławski","Puławy, m.","061401",41506,23249,23246,23033,13428,9605
"lubelskie","puławski","Wąwolnica, gm.","061410",3863,1946,1946,1928,1511,417
"lubelskie","puławski","Żyrzyn, gm.","061411",5128,2572,2572,2547,1940,607
"lubelskie","radzyński","Borki, gm.","061502",4858,2081,2081,2063,1681,382
"lubelskie","radzyński","Czemierniki, gm.","061503",3713,1949,1949,1932,1616,316
"lubelskie","radzyński","Kąkolewnica Wschodnia, gm.","061504",6545,3367,3363,3342,2720,622
"lubelskie","radzyński","Komarówka Podlaska, gm.","061505",3940,1896,1896,1874,1541,333
"lubelskie","radzyński","Radzyń Podlaski, gm.","061506",6138,3000,3000,2969,2477,492
"lubelskie","radzyński","Radzyń Podlaski, m.","061501",13208,7029,7025,6932,4612,2320
"lubelskie","radzyński","Ulan-Majorat, gm.","061507",4667,2641,2641,2617,2293,324
"lubelskie","radzyński","Wohyń, gm.","061508",5940,2717,2716,2685,2135,550
"lubelskie","rycki","Dęblin, m.","061601",14766,7261,7261,7171,4201,2970
"lubelskie","rycki","Kłoczew, gm.","061602",5841,2973,2973,2924,2598,326
"lubelskie","rycki","Nowodwór, gm.","061603",3281,1706,1706,1689,1353,336
"lubelskie","rycki","Ryki, gm.","061604",16699,8259,8256,8164,5806,2358
"lubelskie","rycki","Stężyca, gm.","061605",4452,2088,2088,2056,1584,472
"lubelskie","rycki","Ułęż, gm.","061606",2913,1354,1354,1335,953,382
"lubelskie","świdnicki","Mełgiew, gm.","061702",6198,3008,3008,2995,2358,637
"lubelskie","świdnicki","Piaski, gm.","061703",8533,3644,3644,3616,2836,780
"lubelskie","świdnicki","Rybczewice, gm.","061704",3294,1515,1514,1494,1294,200
"lubelskie","świdnicki","Świdnik, m.","061701",33220,18566,18565,18401,11133,7268
"lubelskie","świdnicki","Trawniki, gm.","061705",7304,3050,3050,3025,2201,824
"lubelskie","tomaszowski","Bełżec, gm.","061802",2374,1011,1011,995,644,351
"lubelskie","tomaszowski","Jarczów, gm.","061803",3084,1450,1450,1438,1199,239
"lubelskie","tomaszowski","Krynice, gm.","061804",2992,1447,1447,1437,1273,164
"lubelskie","tomaszowski","Lubycza Królewska, gm.","061805",5600,1891,1890,1862,1214,648
"lubelskie","tomaszowski","Łaszczów, gm.","061806",5424,2291,2291,2275,1811,464
"lubelskie","tomaszowski","Rachanie, gm.","061807",4712,2238,2238,2219,1883,336
"lubelskie","tomaszowski","Susiec, gm.","061808",6337,2917,2917,2890,2389,501
"lubelskie","tomaszowski","Tarnawatka, gm.","061809",3219,1415,1415,1406,1093,313
"lubelskie","tomaszowski","Telatyn, gm.","061810",3724,1538,1538,1527,1291,236
"lubelskie","tomaszowski","Tomaszów Lubelski, gm.","061811",8392,3921,3920,3890,3074,816
"lubelskie","tomaszowski","Tomaszów Lubelski, m.","061801",16834,8379,8379,8308,5284,3024
"lubelskie","tomaszowski","Tyszowce, gm.","061812",5169,2073,2073,2051,1663,388
"lubelskie","tomaszowski","Ulhówek, gm.","061813",4320,1661,1661,1648,1303,345
"lubelskie","włodawski","Hanna, gm.","061902",2715,1248,1247,1225,988,237
"lubelskie","włodawski","Hańsk, gm.","061903",3135,1204,1204,1190,796,394
"lubelskie","włodawski","Stary Brus, gm.","061904",1808,824,824,819,640,179
"lubelskie","włodawski","Urszulin, gm.","061905",3331,1697,1697,1682,1342,340
"lubelskie","włodawski","Włodawa, gm.","061906",4689,2012,2012,1975,1326,649
"lubelskie","włodawski","Włodawa, m.","061901",11982,5644,5644,5584,3009,2575
"lubelskie","włodawski","Wola Uhruska, gm.","061907",3424,1474,1474,1462,1051,411
"lubelskie","włodawski","Wyryki, gm.","061908",2369,958,958,946,703,243
"lubelskie","zamojski","Adamów, gm.","062001",4019,1924,1924,1916,1671,245
"lubelskie","zamojski","Grabowiec, gm.","062002",3797,1486,1486,1473,1254,219
"lubelskie","zamojski","Komarów-Osada, gm.","062003",4480,2428,2428,2397,2034,363
"lubelskie","zamojski","Krasnobród, gm.","062004",5598,3110,3110,3092,2651,441
"lubelskie","zamojski","Łabunie, gm.","062005",4754,2690,2690,2679,2412,267
"lubelskie","zamojski","Miączyn, gm.","062006",4981,2078,2078,2062,1711,351
"lubelskie","zamojski","Nielisz, gm.","062007",4935,2115,2115,2096,1814,282
"lubelskie","zamojski","Radecznica, gm.","062008",5554,2482,2482,2466,2153,313
"lubelskie","zamojski","Sitno, gm.","062009",5343,2882,2881,2865,2525,340
"lubelskie","zamojski","Skierbieszów, gm.","062010",4619,2161,2161,2151,1835,316
"lubelskie","zamojski","Stary Zamość, gm.","062011",4297,2158,2158,2142,1873,269
"lubelskie","zamojski","Sułów, gm.","062012",4206,1691,1691,1678,1433,245
"lubelskie","zamojski","Szczebrzeszyn, gm.","062013",9657,4350,4347,4306,3364,942
"lubelskie","zamojski","Zamość, gm.","062014",15487,7824,7823,7759,6227,1532
"lubelskie","zamojski","Zwierzyniec, gm.","062015",5768,2327,2326,2307,1547,760
"lubelskie","Biała Podlaska","Biała Podlaska, m.","066101",44839,24243,24235,23975,14416,9559
"lubelskie","Chełm","Chełm, m.","066201",56060,27255,27245,26938,15797,11141
"lubelskie","Lublin","Lublin, m.","066301",281566,169338,169267,167796,94097,73699
"lubelskie","Zamość","Zamość, m.","066401",53689,27417,27409,27131,17424,9707
"lubuskie","gorzowski","Bogdaniec, gm.","080102",5024,2160,2160,2146,1197,949
"lubuskie","gorzowski","Deszczno, gm.","080103",5627,2482,2482,2459,1419,1040
"lubuskie","gorzowski","Kłodawa, gm.","080104",4495,2210,2210,2187,937,1250
"lubuskie","gorzowski","Kostrzyn nad Odrą, m.","080101",13846,6442,6442,6371,2746,3625
"lubuskie","gorzowski","Lubiszyn, gm.","080105",5218,2071,2071,2052,1084,968
"lubuskie","gorzowski","Santok, gm.","080106",5634,2339,2339,2315,1058,1257
"lubuskie","gorzowski","Witnica, gm.","080107",9806,4142,4138,4105,2051,2054
"lubuskie","krośnieński","Bobrowice, gm.","080202",2526,956,956,950,431,519
"lubuskie","krośnieński","Bytnica, gm.","080203",2072,723,723,714,359,355
"lubuskie","krośnieński","Dąbie, gm.","080204",3875,1475,1475,1455,607,848
"lubuskie","krośnieński","Gubin, gm.","080205",5663,1928,1926,1916,813,1103
"lubuskie","krośnieński","Gubin, m.","080201",13640,5918,5918,5846,1855,3991
"lubuskie","krośnieński","Krosno Odrzańskie, gm.","080206",14865,6566,6566,6481,2570,3911
"lubuskie","krośnieński","Maszewo, gm.","080207",2282,624,624,620,281,339
"lubuskie","międzyrzecki","Bledzew, gm.","080301",3728,1344,1344,1326,595,731
"lubuskie","międzyrzecki","Międzyrzecz, gm.","080302",20575,9182,9178,9053,3732,5321
"lubuskie","międzyrzecki","Przytoczna, gm.","080303",4597,1910,1910,1875,823,1052
"lubuskie","międzyrzecki","Pszczew, gm.","080304",3279,1407,1407,1396,639,757
"lubuskie","międzyrzecki","Skwierzyna, gm.","080305",10087,4293,4292,4236,1746,2490
"lubuskie","międzyrzecki","Trzciel, gm.","080306",5095,2193,2193,2179,1004,1175
"lubuskie","nowosolski","Bytom Odrzański, gm.","080402",4111,1826,1826,1805,663,1142
"lubuskie","nowosolski","Kolsko, gm.","080403",2525,982,982,975,409,566
"lubuskie","nowosolski","Kożuchów, gm.","080404",12514,5162,5160,5101,2431,2670
"lubuskie","nowosolski","Nowa Sól, gm.","080405",5009,2236,2236,2213,1296,917
"lubuskie","nowosolski","Nowa Sól, m.","080401",33330,16574,16569,16440,7160,9280
"lubuskie","nowosolski","Nowe Miasteczko, gm.","080406",4306,1764,1763,1738,909,829
"lubuskie","nowosolski","Otyń, gm.","080407",4546,1959,1959,1944,906,1038
"lubuskie","nowosolski","Siedlisko, gm.","080408",2593,1022,1022,1015,521,494
"lubuskie","słubicki","Cybinka, gm.","080501",5286,2071,2069,2042,849,1193
"lubuskie","słubicki","Górzyca, gm.","080502",3129,1256,1256,1230,604,626
"lubuskie","słubicki","Ośno Lubuskie, gm.","080503",4874,1929,1929,1891,728,1163
"lubuskie","słubicki","Rzepin, gm.","080504",7617,3153,3151,3112,1350,1762
"lubuskie","słubicki","Słubice, gm.","080505",15332,7295,7294,7212,2574,4638
"lubuskie","strzelecko-drezdenecki","Dobiegniew, gm.","080601",5592,1895,1895,1877,813,1064
"lubuskie","strzelecko-drezdenecki","Drezdenko, gm.","080602",13837,5640,5640,5574,2682,2892
"lubuskie","strzelecko-drezdenecki","Stare Kurowo, gm.","080603",3264,1345,1345,1335,568,767
"lubuskie","strzelecko-drezdenecki","Strzelce Krajeńskie, gm.","080604",13810,5151,5151,5076,2098,2978
"lubuskie","strzelecko-drezdenecki","Zwierzyn, gm.","080605",3356,1362,1362,1349,684,665
"lubuskie","sulęciński","Krzeszyce, gm.","080701",3485,1453,1452,1433,831,602
"lubuskie","sulęciński","Lubniewice, gm.","080702",2436,1115,1114,1094,467,627
"lubuskie","sulęciński","Słońsk, gm.","080703",3974,1730,1730,1708,835,873
"lubuskie","sulęciński","Sulęcin, gm.","080704",12640,5657,5656,5601,2722,2879
"lubuskie","sulęciński","Torzym, gm.","080705",5603,1961,1961,1920,792,1128
"lubuskie","świebodziński","Lubrza, gm.","080801",2506,881,881,872,346,526
"lubuskie","świebodziński","Łagów, gm.","080802",4178,1665,1665,1656,710,946
"lubuskie","świebodziński","Skąpe, gm.","080803",4074,1530,1530,1507,607,900
"lubuskie","świebodziński","Szczaniec, gm.","080804",3026,1333,1333,1312,691,621
"lubuskie","świebodziński","Świebodzin, gm.","080805",23499,11162,11161,11077,4673,6404
"lubuskie","świebodziński","Zbąszynek, gm.","080806",6460,2886,2886,2850,1080,1770
"lubuskie","zielonogórski","Babimost, gm.","080901",4860,2167,2167,2127,890,1237
"lubuskie","zielonogórski","Bojadła, gm.","080902",2588,1075,1075,1059,477,582
"lubuskie","zielonogórski","Czerwieńsk, gm.","080903",7296,3185,3185,3158,1299,1859
"lubuskie","zielonogórski","Kargowa, gm.","080904",4401,1825,1825,1806,616,1190
"lubuskie","zielonogórski","Nowogród Bobrzański, gm.","080905",7703,3325,3325,3296,1203,2093
"lubuskie","zielonogórski","Sulechów, gm.","080906",20532,9584,9582,9497,3820,5677
"lubuskie","zielonogórski","Świdnica, gm.","080907",4211,1911,1911,1890,703,1187
"lubuskie","zielonogórski","Trzebiechów, gm.","080908",2522,955,955,933,414,519
"lubuskie","zielonogórski","Zabór, gm.","080909",2595,1082,1082,1075,430,645
"lubuskie","zielonogórski","Zielona Góra, gm.","080910",11999,6221,6221,6167,2546,3621
"lubuskie","żagański","Brzeźnica, gm.","081003",2888,1259,1257,1245,706,539
"lubuskie","żagański","Gozdnica, m.","081001",2801,1014,1014,1004,400,604
"lubuskie","żagański","Iłowa, gm.","081004",5707,2222,2222,2204,836,1368
"lubuskie","żagański","Małomice, gm.","081005",4422,1729,1729,1714,684,1030
"lubuskie","żagański","Niegosławice, gm.","081006",3614,1348,1348,1333,832,501
"lubuskie","żagański","Szprotawa, gm.","081007",17335,6557,6557,6491,2912,3579
"lubuskie","żagański","Wymiarki, gm.","081008",1990,731,731,722,282,440
"lubuskie","żagański","Żagań, gm.","081009",5288,1947,1947,1925,872,1053
"lubuskie","żagański","Żagań, m.","081002",21833,10064,10059,9935,3871,6064
"lubuskie","żarski","Brody, gm.","081103",2735,873,873,862,347,515
"lubuskie","żarski","Jasień, gm.","081104",5744,2105,2105,2090,854,1236
"lubuskie","żarski","Lipinki Łużyckie, gm.","081105",2508,935,935,925,407,518
"lubuskie","żarski","Lubsko, gm.","081106",15715,6154,6142,6052,2231,3821
"lubuskie","żarski","Łęknica, m.","081101",1997,725,725,722,219,503
"lubuskie","żarski","Przewóz, gm.","081107",2490,944,944,936,433,503
"lubuskie","żarski","Trzebiel, gm.","081108",4534,1625,1625,1606,648,958
"lubuskie","żarski","Tuplice, gm.","081109",2576,840,840,829,323,506
"lubuskie","żarski","Żary, gm.","081110",8791,3506,3505,3477,1685,1792
"lubuskie","żarski","Żary, m.","081102",32087,14901,14900,14762,5820,8942
"lubuskie","wschowski","Sława, gm.","081201",9183,3847,3847,3798,1598,2200
"lubuskie","wschowski","Szlichtyngowa, gm.","081202",3770,1489,1488,1478,867,611
"lubuskie","wschowski","Wschowa, gm.","081203",16710,7861,7861,7790,3917,3873
"lubuskie","Gorzów Wielkopolski","Gorzów Wielkopolski, m.","086101",99742,51601,51593,51110,23281,27829
"lubuskie","Zielona Góra","Zielona Góra, m.","086201",93961,53474,53448,52923,19240,33683
"łódzkie","bełchatowski","Bełchatów, gm.","100102",7006,3612,3612,3589,2842,747
"łódzkie","bełchatowski","Bełchatów, m.","100101",49691,26803,26798,26455,17746,8709
"łódzkie","bełchatowski","Drużbice, gm.","100103",3936,1724,1724,1692,1408,284
"łódzkie","bełchatowski","Kleszczów, gm.","100104",3111,1598,1598,1583,1211,372
"łódzkie","bełchatowski","Kluki, gm.","100105",3014,1265,1264,1248,1006,242
"łódzkie","bełchatowski","Rusiec, gm.","100106",4172,2015,2015,1991,1600,391
"łódzkie","bełchatowski","Szczerców, gm.","100107",5881,2785,2785,2747,2080,667
"łódzkie","bełchatowski","Zelów, gm.","100108",12109,5821,5820,5755,4324,1431
"łódzkie","kutnowski","Bedlno, gm.","100202",5060,1885,1885,1863,1620,243
"łódzkie","kutnowski","Dąbrowice, gm.","100203",1717,610,610,607,504,103
"łódzkie","kutnowski","Krośniewice, gm.","100204",7413,2728,2727,2685,1732,953
"łódzkie","kutnowski","Krzyżanów, gm.","100205",3622,1283,1283,1270,1022,248
"łódzkie","kutnowski","Kutno, gm.","100206",6546,2671,2671,2653,2056,597
"łódzkie","kutnowski","Kutno, m.","100201",39901,19571,19564,19294,11404,7890
"łódzkie","kutnowski","Łanięta, gm.","100207",2074,724,724,713,535,178
"łódzkie","kutnowski","Nowe Ostrowy, gm.","100208",3166,1055,1055,1032,723,309
"łódzkie","kutnowski","Oporów, gm.","100209",2256,848,848,824,697,127
"łódzkie","kutnowski","Strzelce, gm.","100210",3339,1282,1282,1272,1020,252
"łódzkie","kutnowski","Żychlin, gm.","100211",11138,4235,4234,4178,2824,1354
"łódzkie","łaski","Buczek, gm.","100301",3858,1570,1568,1555,1176,379
"łódzkie","łaski","Łask, gm.","100302",22854,10871,10870,10754,6592,4162
"łódzkie","łaski","Sędziejowice, gm.","100303",5043,2231,2231,2209,1689,520
"łódzkie","łaski","Widawa, gm.","100304",6409,2787,2787,2758,2205,553
"łódzkie","łaski","Wodzierady, gm.","100305",2430,994,992,983,746,237
"łódzkie","łęczycki","Daszyna, gm.","100402",3528,1129,1129,1115,899,216
"łódzkie","łęczycki","Góra Świętej Małgorzaty, gm.","100403",3679,1543,1543,1527,1342,185
"łódzkie","łęczycki","Grabów, gm.","100404",5289,2067,2066,2045,1735,310
"łódzkie","łęczycki","Łęczyca, gm.","100405",7122,2990,2989,2975,2345,630
"łódzkie","łęczycki","Łęczyca, m.","100401",13222,6340,6338,6261,3092,3169
"łódzkie","łęczycki","Piątek, gm.","100406",5217,2098,2098,2082,1667,415
"łódzkie","łęczycki","Świnice Warckie, gm.","100407",3298,1323,1322,1312,1007,305
"łódzkie","łęczycki","Witonia, gm.","100408",2887,1016,1016,1002,809,193
"łódzkie","łowicki","Bielawy, gm.","100502",4838,1798,1798,1768,1365,403
"łódzkie","łowicki","Chąśno, gm.","100503",2500,1128,1128,1124,1011,113
"łódzkie","łowicki","Domaniewice, gm.","100504",3740,1611,1610,1594,1349,245
"łódzkie","łowicki","Kiernozia, gm.","100505",3019,1296,1296,1280,1090,190
"łódzkie","łowicki","Kocierzew Południowy, gm.","100506",3570,1961,1960,1937,1781,156
"łódzkie","łowicki","Łowicz, gm.","100507",5735,2598,2598,2571,2094,477
"łódzkie","łowicki","Łowicz, m.","100501",25593,12812,12804,12622,7001,5621
"łódzkie","łowicki","Łyszkowice, gm.","100508",5360,2095,2094,2069,1558,511
"łódzkie","łowicki","Nieborów, gm.","100509",7456,3465,3465,3439,2466,973
"łódzkie","łowicki","Zduny, gm.","100510",5009,2133,2133,2104,1744,360
"łódzkie","łódzki wschodni","Andrespol, gm.","100602",9049,4973,4972,4916,2925,1991
"łódzkie","łódzki wschodni","Brójce, gm.","100603",4096,2056,2056,2024,1562,462
"łódzkie","łódzki wschodni","Koluszki, gm.","100607",18587,9720,9711,9620,6015,3605
"łódzkie","łódzki wschodni","Nowosolna, gm.","100608",2634,1400,1400,1389,821,568
"łódzkie","łódzki wschodni","Rzgów, gm.","100610",6888,3891,3890,3858,2645,1213
"łódzkie","łódzki wschodni","Tuszyn, gm.","100611",9747,4668,4668,4630,3064,1566
"łódzkie","opoczyński","Białaczów, gm.","100701",4748,2067,2066,2041,1540,501
"łódzkie","opoczyński","Drzewica, gm.","100702",8768,4698,4697,4635,3685,950
"łódzkie","opoczyński","Mniszków, gm.","100703",3730,1800,1800,1782,1551,231
"łódzkie","opoczyński","Opoczno, gm.","100704",27710,15025,15023,14866,10783,4083
"łódzkie","opoczyński","Paradyż, gm.","100705",3470,1776,1776,1759,1539,220
"łódzkie","opoczyński","Poświętne, gm.","100706",2767,1573,1573,1547,1351,196
"łódzkie","opoczyński","Sławno, gm.","100707",5779,3077,3077,3061,2660,401
"łódzkie","opoczyński","Żarnów, gm.","100708",5025,2232,2231,2208,1712,496
"łódzkie","pabianicki","Dłutów, gm.","100803",3273,1584,1584,1570,1223,347
"łódzkie","pabianicki","Dobroń, gm.","100804",5177,2724,2724,2699,1778,921
"łódzkie","pabianicki","Konstantynów Łódzki, m.","100801",14142,7229,7228,7131,3792,3339
"łódzkie","pabianicki","Ksawerów, gm.","100805",5743,3012,3012,2964,1692,1272
"łódzkie","pabianicki","Lutomiersk, gm.","100806",5477,2487,2485,2468,1760,708
"łódzkie","pabianicki","Pabianice, gm.","100807",4345,2480,2480,2456,1686,770
"łódzkie","pabianicki","Pabianice, m.","100802",59106,31809,31796,31419,15875,15544
"łódzkie","pajęczański","Działoszyn, gm.","100901",10161,4338,4338,4288,3004,1284
"łódzkie","pajęczański","Kiełczygłów, gm.","100902",3512,1550,1550,1531,1181,350
"łódzkie","pajęczański","Nowa Brzeźnica, gm.","100903",3980,1628,1628,1614,1198,416
"łódzkie","pajęczański","Pajęczno, gm.","100904",9426,4340,4338,4298,3027,1271
"łódzkie","pajęczański","Rząśnia, gm.","100905",3670,1618,1618,1600,1339,261
"łódzkie","pajęczański","Siemkowice, gm.","100906",3965,1699,1699,1676,1336,340
"łódzkie","pajęczański","Strzelce Wielkie, gm.","100907",3920,1707,1707,1681,1386,295
"łódzkie","pajęczański","Sulmierzyce, gm.","100908",3768,1676,1676,1650,1318,332
"łódzkie","piotrkowski","Aleksandrów, gm.","101001",3772,1661,1661,1645,1357,288
"łódzkie","piotrkowski","Czarnocin, gm.","101002",3166,1599,1599,1583,1344,239
"łódzkie","piotrkowski","Gorzkowice, gm.","101003",6735,2813,2812,2776,2252,524
"łódzkie","piotrkowski","Grabica, gm.","101004",4723,2289,2289,2256,1953,303
"łódzkie","piotrkowski","Łęki Szlacheckie, gm.","101005",2979,1134,1134,1118,935,183
"łódzkie","piotrkowski","Moszczenica, gm.","101006",9839,5095,5092,5055,4043,1012
"łódzkie","piotrkowski","Ręczno, gm.","101007",3021,1277,1277,1259,945,314
"łódzkie","piotrkowski","Rozprza, gm.","101008",9283,3931,3928,3887,3038,849
"łódzkie","piotrkowski","Sulejów, gm.","101009",11944,6159,6157,6105,4532,1573
"łódzkie","piotrkowski","Wola Krzysztoporska, gm.","101010",8872,4605,4603,4555,3905,650
"łódzkie","piotrkowski","Wolbórz, gm.","101011",6149,3261,3261,3230,2407,823
"łódzkie","poddębicki","Dalików, gm.","101101",2979,1294,1294,1272,1028,244
"łódzkie","poddębicki","Pęczniew, gm.","101102",3006,1343,1343,1308,1035,273
"łódzkie","poddębicki","Poddębice, gm.","101103",12891,5074,5072,4991,3245,1746
"łódzkie","poddębicki","Uniejów, gm.","101104",6183,2890,2888,2846,2136,710
"łódzkie","poddębicki","Wartkowice, gm.","101105",5077,1825,1825,1803,1419,384
"łódzkie","poddębicki","Zadzim, gm.","101106",4381,1773,1773,1755,1392,363
"łódzkie","radomszczański","Dobryszyce, gm.","101202",3176,1357,1357,1316,960,356
"łódzkie","radomszczański","Gidle, gm.","101203",5402,2118,2118,2082,1444,638
"łódzkie","radomszczański","Gomunice, gm.","101204",4672,2270,2270,2239,1662,577
"łódzkie","radomszczański","Kamieńsk, gm.","101205",4658,2215,2215,2192,1770,422
"łódzkie","radomszczański","Kobiele Wielkie, gm.","101206",3512,1291,1290,1274,983,291
"łódzkie","radomszczański","Kodrąb, gm.","101207",3782,1505,1505,1493,1200,293
"łódzkie","radomszczański","Lgota Wielka, gm.","101208",3441,1453,1453,1435,1120,315
"łódzkie","radomszczański","Ładzice, gm.","101209",3832,1512,1512,1500,1090,410
"łódzkie","radomszczański","Masłowice, gm.","101210",3562,1284,1284,1260,985,275
"łódzkie","radomszczański","Przedbórz, gm.","101211",6178,2660,2660,2637,1885,752
"łódzkie","radomszczański","Radomsko, gm.","101212",4385,1826,1826,1807,1318,489
"łódzkie","radomszczański","Radomsko, m.","101201",39875,19170,19165,18981,11587,7394
"łódzkie","radomszczański","Wielgomłyny, gm.","101213",3964,1469,1465,1445,1168,277
"łódzkie","radomszczański","Żytno, gm.","101214",4740,1676,1676,1660,1252,408
"łódzkie","rawski","Biała Rawska, gm.","101302",9258,3720,3720,3680,2877,803
"łódzkie","rawski","Cielądz, gm.","101303",3241,1321,1321,1308,1093,215
"łódzkie","rawski","Rawa Mazowiecka, gm.","101304",6519,2632,2632,2608,2177,431
"łódzkie","rawski","Rawa Mazowiecka, m.","101301",14625,7156,7156,7067,4483,2584
"łódzkie","rawski","Regnów, gm.","101305",1439,545,545,542,472,70
"łódzkie","rawski","Sadkowice, gm.","101306",4677,1724,1724,1714,1439,275
"łódzkie","sieradzki","Błaszki, gm.","101402",11824,5189,5186,5124,4124,1000
"łódzkie","sieradzki","Brąszewice, gm.","101403",3317,1554,1554,1540,1285,255
"łódzkie","sieradzki","Brzeźnio, gm.","101404",4899,2253,2250,2222,1681,541
"łódzkie","sieradzki","Burzenin, gm.","101405",4473,1987,1987,1962,1471,491
"łódzkie","sieradzki","Goszczanów, gm.","101406",4462,1739,1735,1711,1458,253
"łódzkie","sieradzki","Klonowa, gm.","101407",2370,1036,1036,1019,791,228
"łódzkie","sieradzki","Sieradz, gm.","101408",7409,3541,3537,3517,2778,739
"łódzkie","sieradzki","Sieradz, m.","101401",37324,19580,19569,19310,10748,8562
"łódzkie","sieradzki","Warta, gm.","101409",10780,5117,5115,5063,3944,1119
"łódzkie","sieradzki","Wróblew, gm.","101410",4933,2084,2082,2054,1677,377
"łódzkie","sieradzki","Złoczew, gm.","101411",5716,2622,2619,2579,2015,564
"łódzkie","skierniewicki","Bolimów, gm.","101501",3228,1329,1329,1311,973,338
"łódzkie","skierniewicki","Głuchów, gm.","101502",4778,2920,2914,2889,2599,290
"łódzkie","skierniewicki","Godzianów, gm.","101503",2104,1190,1190,1183,1032,151
"łódzkie","skierniewicki","Kowiesy, gm.","101504",2461,1061,1061,1048,823,225
"łódzkie","skierniewicki","Lipce Reymontowskie, gm.","101505",2637,1235,1235,1222,923,299
"łódzkie","skierniewicki","Maków, gm.","101506",4661,2235,2235,2208,1687,521
"łódzkie","skierniewicki","Nowy Kawęczyn, gm.","101507",2618,1143,1143,1110,886,224
"łódzkie","skierniewicki","Skierniewice, gm.","101508",5266,2383,2383,2356,1757,599
"łódzkie","skierniewicki","Słupia, gm.","101509",2090,1031,1031,1023,896,127
"łódzkie","tomaszowski","Będków, gm.","101602",2776,1371,1371,1355,1143,212
"łódzkie","tomaszowski","Budziszewice, gm.","101603",1816,960,960,910,714,196
"łódzkie","tomaszowski","Czerniewice, gm.","101604",4136,1775,1773,1747,1411,336
"łódzkie","tomaszowski","Inowłódz, gm.","101605",3208,1644,1644,1627,1065,562
"łódzkie","tomaszowski","Lubochnia, gm.","101606",5790,2924,2924,2858,2228,630
"łódzkie","tomaszowski","Rokiciny, gm.","101607",4729,2476,2476,2454,1925,529
"łódzkie","tomaszowski","Rzeczyca, gm.","101608",3987,1805,1804,1781,1489,292
"łódzkie","tomaszowski","Tomaszów Mazowiecki, gm.","101609",7679,3936,3934,3894,2771,1123
"łódzkie","tomaszowski","Tomaszów Mazowiecki, m.","101601",54588,27932,27929,27588,15050,12538
"łódzkie","tomaszowski","Ujazd, gm.","101610",6364,3166,3166,3128,2111,1017
"łódzkie","tomaszowski","Żelechlinek, gm.","101611",2741,1254,1254,1241,1109,132
"łódzkie","wieluński","Biała, gm.","101701",4313,1815,1815,1804,1357,447
"łódzkie","wieluński","Czarnożyły, gm.","101702",3526,1637,1637,1618,1303,315
"łódzkie","wieluński","Konopnica, gm.","101703",3290,1478,1478,1454,979,475
"łódzkie","wieluński","Mokrsko, gm.","101704",4246,2064,2064,2028,1415,613
"łódzkie","wieluński","Osjaków, gm.","101705",3702,1798,1798,1771,1410,361
"łódzkie","wieluński","Ostrówek, gm.","101706",3646,1610,1610,1578,1200,378
"łódzkie","wieluński","Pątnów, gm.","101707",4944,2317,2316,2296,1852,444
"łódzkie","wieluński","Skomlin, gm.","101708",2742,1260,1259,1234,876,358
"łódzkie","wieluński","Wieluń, gm.","101709",26912,12998,12996,12825,7345,5480
"łódzkie","wieluński","Wierzchlas, gm.","101710",5158,2148,2148,2118,1449,669
"łódzkie","wieruszowski","Bolesławiec, gm.","101801",3266,1416,1416,1386,950,436
"łódzkie","wieruszowski","Czastary, gm.","101802",3128,1336,1335,1323,1001,322
"łódzkie","wieruszowski","Galewice, gm.","101803",4799,2033,2033,2020,1417,603
"łódzkie","wieruszowski","Lututów, gm.","101804",3780,1592,1591,1552,1198,354
"łódzkie","wieruszowski","Łubnice, gm.","101805",3182,1333,1333,1316,1022,294
"łódzkie","wieruszowski","Sokolniki, gm.","101806",3868,1711,1711,1694,1202,492
"łódzkie","wieruszowski","Wieruszów, gm.","101807",11316,5569,5566,5495,3151,2344
"łódzkie","zduńskowolski","Szadek, gm.","101902",5823,2561,2560,2525,1895,630
"łódzkie","zduńskowolski","Zapolice, gm.","101903",3655,1443,1443,1426,971,455
"łódzkie","zduńskowolski","Zduńska Wola, gm.","101904",8404,3942,3940,3912,2852,1060
"łódzkie","zduńskowolski","Zduńska Wola, m.","101901",35915,18719,18716,18513,10426,8087
"łódzkie","zgierski","Aleksandrów Łódzki, gm.","102004",21146,10400,10396,10293,5594,4699
"łódzkie","zgierski","Głowno, gm.","102005",3901,1613,1612,1597,1357,240
"łódzkie","zgierski","Głowno, m.","102001",12567,5571,5567,5487,3035,2452
"łódzkie","zgierski","Ozorków, gm.","102006",5112,2488,2488,2463,1887,576
"łódzkie","zgierski","Ozorków, m.","102002",16911,7821,7815,7723,4370,3353
"łódzkie","zgierski","Parzęczew, gm.","102007",4115,1742,1741,1722,1100,622
"łódzkie","zgierski","Stryków, gm.","102008",9662,4295,4295,4257,2655,1602
"łódzkie","zgierski","Zgierz, gm.","102009",8589,4502,4501,4457,2966,1491
"łódzkie","zgierski","Zgierz, m.","102003",48263,25866,25850,25532,13751,11781
"łódzkie","brzeziński","Brzeziny, gm.","102102",4078,1848,1848,1831,1503,328
"łódzkie","brzeziński","Brzeziny, m.","102101",10043,4863,4864,4792,3006,1786
"łódzkie","brzeziński","Dmosin, gm.","102103",3792,1547,1546,1529,1248,281
"łódzkie","brzeziński","Jeżów, gm.","102104",2851,1595,1595,1579,1305,274
"łódzkie","brzeziński","Rogów, gm.","102105",3728,1833,1832,1810,1300,510
"łódzkie","Łódź","Łódź, m.","106101",628658,347359,347158,342804,153929,188875
"łódzkie","Piotrków Trybunalski","Piotrków Trybunalski, m.","106201",64185,34964,34949,34485,20144,14341
"łódzkie","Skierniewice","Skierniewice, m.","106301",38748,20579,20569,20318,10604,9714
"małopolskie","bocheński","Bochnia, gm.","120102",13813,7261,7261,7233,5241,1992
"małopolskie","bocheński","Bochnia, m.","120101",23338,13672,13668,13542,7760,5782
"małopolskie","bocheński","Drwinia, gm.","120103",4806,2671,2671,2655,2218,437
"małopolskie","bocheński","Lipnica Murowana, gm.","120104",3999,2142,2140,2118,1629,489
"małopolskie","bocheński","Łapanów, gm.","120105",5381,2813,2813,2780,2043,737
"małopolskie","bocheński","Nowy Wiśnicz, gm.","120106",9641,5793,5793,5750,4104,1646
"małopolskie","bocheński","Rzezawa, gm.","120107",7744,4344,4343,4321,3399,922
"małopolskie","bocheński","Trzciana, gm.","120108",3703,2174,2174,2159,1726,433
"małopolskie","bocheński","Żegocina, gm.","120109",3681,2391,2390,2372,2050,322
"małopolskie","brzeski","Borzęcin, gm.","120201",6284,3200,3199,3170,2365,805
"małopolskie","brzeski","Brzesko, gm.","120202",27454,15248,15245,15131,9776,5355
"małopolskie","brzeski","Czchów, gm.","120203",6788,3856,3858,3829,2908,921
"małopolskie","brzeski","Dębno, gm.","120204",10288,5886,5886,5842,4374,1468
"małopolskie","brzeski","Gnojnik, gm.","120205",5354,2818,2818,2790,2151,639
"małopolskie","brzeski","Iwkowa, gm.","120206",4376,2462,2462,2443,2031,412
"małopolskie","brzeski","Szczurowa, gm.","120207",7697,3750,3750,3723,2805,918
"małopolskie","chrzanowski","Alwernia, gm.","120301",9880,5022,5020,4973,2877,2096
"małopolskie","chrzanowski","Babice, gm.","120302",6870,3607,3607,3566,2095,1471
"małopolskie","chrzanowski","Chrzanów, gm.","120303",40945,21130,21122,20865,9799,11066
"małopolskie","chrzanowski","Libiąż, gm.","120304",18235,9305,9303,9212,5525,3687
"małopolskie","chrzanowski","Trzebinia, gm.","120305",27990,14197,14192,14031,6904,7127
"małopolskie","dąbrowski","Bolesław, gm.","120401",2304,1037,1037,1026,874,152
"małopolskie","dąbrowski","Dąbrowa Tarnowska, gm.","120402",15982,7936,7934,7876,6175,1701
"małopolskie","dąbrowski","Gręboszów, gm.","120403",2913,1512,1512,1507,1333,174
"małopolskie","dąbrowski","Mędrzechów, gm.","120404",2773,1275,1275,1263,1022,241
"małopolskie","dąbrowski","Olesno, gm.","120405",5881,3147,3147,3138,2775,363
"małopolskie","dąbrowski","Radgoszcz, gm.","120406",5369,2922,2921,2907,2712,195
"małopolskie","dąbrowski","Szczucin, gm.","120407",10284,4956,4955,4919,3858,1061
"małopolskie","gorlicki","Biecz, gm.","120502",13155,6506,6501,6442,4894,1548
"małopolskie","gorlicki","Bobowa, gm.","120503",6621,3548,3548,3516,2850,666
"małopolskie","gorlicki","Gorlice, gm.","120504",12332,6608,6606,6544,4832,1712
"małopolskie","gorlicki","Gorlice, m.","120501",24495,12791,12788,12665,7579,5086
"małopolskie","gorlicki","Lipinki, gm.","120505",5224,2501,2501,2475,1957,518
"małopolskie","gorlicki","Łużna, gm.","120506",6127,3070,3070,3043,2316,727
"małopolskie","gorlicki","Moszczenica, gm.","120507",3583,1798,1798,1791,1467,324
"małopolskie","gorlicki","Ropa, gm.","120508",3589,1992,1992,1981,1569,412
"małopolskie","gorlicki","Sękowa, gm.","120509",3636,1744,1743,1737,1089,648
"małopolskie","gorlicki","Uście Gorlickie, gm.","120510",4710,2036,2036,2014,1170,844
"małopolskie","krakowski","Czernichów, gm.","120601",9868,4831,4830,4774,3193,1581
"małopolskie","krakowski","Igołomia-Wawrzeńczyce, gm.","120602",5860,2290,2290,2277,1724,553
"małopolskie","krakowski","Iwanowice, gm.","120603",6204,3217,3216,3193,2561,632
"małopolskie","krakowski","Jerzmanowice-Przeginia, gm.","120604",7998,4194,4193,4163,3029,1134
"małopolskie","krakowski","Kocmyrzów-Luborzyca, gm.","120605",9771,4671,4671,4640,3274,1366
"małopolskie","krakowski","Krzeszowice, gm.","120606",25216,13639,13637,13531,7840,5691
"małopolskie","krakowski","Liszki, gm.","120607",11760,6498,6498,6466,4175,2291
"małopolskie","krakowski","Michałowice, gm.","120608",5820,3083,3083,3070,1979,1091
"małopolskie","krakowski","Mogilany, gm.","120609",8086,4749,4748,4715,2811,1904
"małopolskie","krakowski","Skała, gm.","120610",7473,3809,3808,3781,2622,1159
"małopolskie","krakowski","Skawina, gm.","120611",32096,18288,18274,18132,10425,7707
"małopolskie","krakowski","Słomniki, gm.","120612",10642,5329,5328,5290,3805,1485
"małopolskie","krakowski","Sułoszowa, gm.","120613",4525,2388,2388,2370,1983,387
"małopolskie","krakowski","Świątniki Górne, gm.","120614",6657,3713,3711,3695,2365,1330
"małopolskie","krakowski","Wielka Wieś, gm.","120615",6995,4042,4042,4018,2489,1529
"małopolskie","krakowski","Zabierzów, gm.","120616",17667,10724,10722,10654,5437,5217
"małopolskie","krakowski","Zielonki, gm.","120617",11380,6684,6684,6648,3600,3048
"małopolskie","limanowski","Dobra, gm.","120703",7101,3411,3410,3384,2451,933
"małopolskie","limanowski","Jodłownik, gm.","120704",6087,3010,3008,2981,2318,663
"małopolskie","limanowski","Kamienica, gm.","120705",5250,2788,2788,2764,2195,569
"małopolskie","limanowski","Laskowa, gm.","120706",5360,3592,3592,3576,3127,449
"małopolskie","limanowski","Limanowa, gm.","120707",16444,9294,9294,9228,7506,1722
"małopolskie","limanowski","Limanowa, m.","120701",11819,6994,6994,6943,4674,2269
"małopolskie","limanowski","Łukowica, gm.","120708",6590,3634,3634,3590,2842,748
"małopolskie","limanowski","Mszana Dolna, gm.","120709",11700,6605,6604,6563,5464,1099
"małopolskie","limanowski","Mszana Dolna, m.","120702",5583,3267,3265,3237,2170,1067
"małopolskie","limanowski","Niedźwiedź, gm.","120710",4765,2193,2193,2173,1606,567
"małopolskie","limanowski","Słopnice, gm.","120711",3995,2280,2280,2271,1891,380
"małopolskie","limanowski","Tymbark, gm.","120712",4423,2763,2763,2746,2250,496
"małopolskie","miechowski","Charsznica, gm.","120801",6328,2438,2436,2405,1915,490
"małopolskie","miechowski","Gołcza, gm.","120802",5044,2202,2202,2176,1671,505
"małopolskie","miechowski","Kozłów, gm.","120803",4044,1586,1586,1569,1327,242
"małopolskie","miechowski","Książ Wielki, gm.","120804",4486,1969,1969,1947,1551,396
"małopolskie","miechowski","Miechów, gm.","120805",16172,7101,7095,7034,4561,2473
"małopolskie","miechowski","Racławice, gm.","120806",2028,672,672,669,533,136
"małopolskie","miechowski","Słaboszów, gm.","120807",3217,1144,1144,1123,896,227
"małopolskie","myślenicki","Dobczyce, gm.","120901",10340,5967,5965,5918,3995,1923
"małopolskie","myślenicki","Lubień, gm.","120902",6677,3845,3845,3826,2832,994
"małopolskie","myślenicki","Myślenice, gm.","120903",30531,18235,18235,18109,11363,6746
"małopolskie","myślenicki","Pcim, gm.","120904",7565,4374,4373,4317,3291,1026
"małopolskie","myślenicki","Raciechowice, gm.","120905",4564,2101,2100,2082,1540,542
"małopolskie","myślenicki","Siepraw, gm.","120906",5759,3251,3251,3233,2228,1005
"małopolskie","myślenicki","Sułkowice, gm.","120907",10256,5267,5266,5223,3354,1869
"małopolskie","myślenicki","Tokarnia, gm.","120908",5827,3507,3507,3491,2649,842
"małopolskie","myślenicki","Wiśniowa, gm.","120909",4990,2873,2872,2857,2342,515
"małopolskie","nowosądecki","Chełmiec, gm.","121002",17314,10581,10581,10518,8391,2127
"małopolskie","nowosądecki","Gródek nad Dunajcem, gm.","121003",6342,3383,3383,3367,2651,716
"małopolskie","nowosądecki","Grybów, gm.","121004",16021,10099,10097,10051,8552,1499
"małopolskie","nowosądecki","Grybów, m.","121001",4870,3048,3048,3033,2269,764
"małopolskie","nowosądecki","Kamionka Wielka, gm.","121005",6362,3917,3917,3905,3134,771
"małopolskie","nowosądecki","Korzenna, gm.","121006",9569,5616,5616,5593,4977,616
"małopolskie","nowosądecki","Krynica-Zdrój, gm.","121007",14146,7727,7726,7650,4815,2835
"małopolskie","nowosądecki","Łabowa, gm.","121008",3565,1968,1968,1957,1638,319
"małopolskie","nowosądecki","Łącko, gm.","121009",10849,6036,6035,5980,4735,1245
"małopolskie","nowosądecki","Łososina Dolna, gm.","121010",7087,4526,4525,4510,3928,582
"małopolskie","nowosądecki","Muszyna, gm.","121011",8551,4700,4700,4667,3099,1568
"małopolskie","nowosądecki","Nawojowa, gm.","121012",5288,3130,3130,3118,2646,472
"małopolskie","nowosądecki","Piwniczna-Zdrój, gm.","121013",7827,4202,4201,4173,2992,1181
"małopolskie","nowosądecki","Podegrodzie, gm.","121014",8198,4828,4828,4789,3910,879
"małopolskie","nowosądecki","Rytro, gm.","121015",2795,1579,1579,1559,1175,384
"małopolskie","nowosądecki","Stary Sącz, gm.","121016",16248,9657,9655,9607,7375,2232
"małopolskie","nowotarski","Czarny Dunajec, gm.","121103",15698,6969,6969,6934,5006,1928
"małopolskie","nowotarski","Czorsztyn, gm.","121104",5283,2622,2622,2604,1341,1263
"małopolskie","nowotarski","Jabłonka, gm.","121105",12335,6327,6326,6293,4861,1432
"małopolskie","nowotarski","Krościenko nad Dunajcem, gm.","121106",4976,2520,2520,2509,1519,990
"małopolskie","nowotarski","Lipnica Wielka, gm.","121107",3908,2104,2103,2085,1456,629
"małopolskie","nowotarski","Łapsze Niżne, gm.","121108",6507,2874,2874,2847,1744,1103
"małopolskie","nowotarski","Nowy Targ, gm.","121109",16113,8233,8228,8187,5356,2831
"małopolskie","nowotarski","Nowy Targ, m.","121101",25941,14489,14480,14378,7497,6881
"małopolskie","nowotarski","Ochotnica Dolna, gm.","121110",5773,2964,2964,2946,2003,943
"małopolskie","nowotarski","Raba Wyżna, gm.","121111",10043,5264,5262,5221,3981,1240
"małopolskie","nowotarski","Rabka-Zdrój, gm.","121112",13659,8031,8030,7992,5393,2599
"małopolskie","nowotarski","Spytkowice, gm.","121113",2932,1554,1553,1542,1192,350
"małopolskie","nowotarski","Szaflary, gm.","121114",7238,3238,3238,3228,2403,825
"małopolskie","nowotarski","Szczawnica, m.","121102",5883,3120,3120,3084,1384,1700
"małopolskie","olkuski","Bolesław, gm.","121203",6328,2588,2588,2539,1424,1115
"małopolskie","olkuski","Bukowno, m.","121201",8677,3646,3645,3596,1959,1637
"małopolskie","olkuski","Klucze, gm.","121204",12205,6115,6111,6054,3195,2859
"małopolskie","olkuski","Olkusz, gm.","121205",41524,22168,22162,21941,13176,8765
"małopolskie","olkuski","Trzyciąż, gm.","121206",5594,2402,2402,2382,1966,416
"małopolskie","olkuski","Wolbrom, gm.","121207",18536,8801,8798,8697,6044,2653
"małopolskie","oświęcimski","Brzeszcze, gm.","121302",17489,9687,9684,9594,5423,4171
"małopolskie","oświęcimski","Chełmek, gm.","121303",10228,5711,5711,5631,3045,2586
"małopolskie","oświęcimski","Kęty, gm.","121304",26332,15334,15332,15210,9073,6137
"małopolskie","oświęcimski","Osiek, gm.","121305",5997,3223,3223,3200,2265,935
"małopolskie","oświęcimski","Oświęcim, gm.","121306",12925,7699,7698,7622,4473,3149
"małopolskie","oświęcimski","Oświęcim, m.","121301",33969,19174,19165,18996,9374,9622
"małopolskie","oświęcimski","Polanka Wielka, gm.","121307",3130,1790,1790,1779,1256,523
"małopolskie","oświęcimski","Przeciszów, gm.","121308",5267,2681,2681,2657,1674,983
"małopolskie","oświęcimski","Zator, gm.","121309",6974,3946,3946,3915,2510,1405
"małopolskie","proszowicki","Koniusza, gm.","121401",6537,2668,2668,2649,2164,485
"małopolskie","proszowicki","Koszyce, gm.","121402",4685,1688,1687,1671,1304,367
"małopolskie","proszowicki","Nowe Brzesko, gm.","121403",4485,1940,1940,1929,1551,378
"małopolskie","proszowicki","Pałecznica, gm.","121404",2853,1116,1116,1104,936,168
"małopolskie","proszowicki","Proszowice, gm.","121405",13196,5632,5632,5576,4083,1493
"małopolskie","proszowicki","Radziemice, gm.","121406",2712,1093,1093,1087,897,190
"małopolskie","Suski","Budzów, gm.","121503",6081,2979,2977,2961,2155,806
"małopolskie","Suski","Bystra-Sidzina, gm.","121504",4602,2475,2475,2451,1739,712
"małopolskie","Suski","Jordanów, gm.","121505",7764,4310,4309,4285,3208,1077
"małopolskie","Suski","Jordanów, m.","121501",4015,2316,2313,2287,1433,854
"małopolskie","Suski","Maków Podhalański, gm.","121506",12372,7106,7106,7074,4848,2226
"małopolskie","Suski","Stryszawa, gm.","121507",9087,5043,5041,4989,3519,1470
"małopolskie","Suski","Sucha Beskidzka, m.","121502",7752,4337,4336,4299,2300,1999
"małopolskie","Suski","Zawoja, gm.","121508",6839,3628,3626,3592,2416,1176
"małopolskie","Suski","Zembrzyce, gm.","121509",4209,2324,2324,2300,1433,867
"małopolskie","tarnowski","Ciężkowice, gm.","121601",8296,4053,4053,4010,3094,916
"małopolskie","tarnowski","Gromnik, gm.","121602",6228,3359,3359,3341,2829,512
"małopolskie","tarnowski","Lisia Góra, gm.","121603",9896,5757,5757,5729,4573,1156
"małopolskie","tarnowski","Pleśna, gm.","121604",8458,4572,4572,4542,3442,1100
"małopolskie","tarnowski","Radłów, gm.","121605",7382,3716,3712,3691,2828,863
"małopolskie","tarnowski","Ryglice, gm.","121606",8391,4536,4536,4492,3635,857
"małopolskie","tarnowski","Rzepiennik Strzyżewski, gm.","121607",5107,2777,2777,2762,2264,498
"małopolskie","tarnowski","Skrzyszów, gm.","121608",9512,5093,5093,5046,3792,1254
"małopolskie","tarnowski","Szerzyny, gm.","121616",6271,3226,3226,3190,2561,629
"małopolskie","tarnowski","Tarnów, gm.","121609",16853,9751,9750,9691,6919,2772
"małopolskie","tarnowski","Tuchów, gm.","121610",13311,7724,7724,7683,5999,1684
"małopolskie","tarnowski","Wierzchosławice, gm.","121611",8080,4518,4518,4491,3328,1163
"małopolskie","tarnowski","Wietrzychowice, gm.","121612",3268,1610,1610,1591,1225,366
"małopolskie","tarnowski","Wojnicz, gm.","121613",9698,5285,5282,5255,3972,1283
"małopolskie","tarnowski","Zakliczyn, gm.","121614",9064,4546,4544,4509,3572,937
"małopolskie","tarnowski","Żabno, gm.","121615",14336,7605,7601,7550,5659,1891
"małopolskie","tatrzański","Biały Dunajec, gm.","121702",5210,2520,2516,2504,1840,664
"małopolskie","tatrzański","Bukowina Tatrzańska, gm.","121703",9257,5064,5063,5030,3525,1505
"małopolskie","tatrzański","Kościelisko, gm.","121704",6045,2968,2968,2946,1782,1164
"małopolskie","tatrzański","Poronin, gm.","121705",7980,4055,4054,4037,2446,1591
"małopolskie","tatrzański","Zakopane, m.","121701",24031,14314,14310,14216,6860,7356
"małopolskie","wadowicki","Andrychów, gm.","121801",33969,19866,19851,19686,12185,7501
"małopolskie","wadowicki","Brzeźnica, gm.","121802",7666,3846,3845,3817,2561,1256
"małopolskie","wadowicki","Kalwaria Zebrzydowska, gm.","121803",14644,8395,8388,8353,4997,3356
"małopolskie","wadowicki","Lanckorona, gm.","121804",4399,2146,2146,2130,1321,809
"małopolskie","wadowicki","Mucharz, gm.","121805",2933,1506,1506,1494,963,531
"małopolskie","wadowicki","Spytkowice, gm.","121806",7058,3722,3720,3701,2533,1168
"małopolskie","wadowicki","Stryszów, gm.","121807",5171,2670,2669,2652,1689,963
"małopolskie","wadowicki","Tomice, gm.","121808",5386,2870,2870,2846,1797,1049
"małopolskie","wadowicki","Wadowice, gm.","121809",29598,16972,16970,16821,9403,7418
"małopolskie","wadowicki","Wieprz, gm.","121810",8528,4919,4919,4891,3659,1232
"małopolskie","wielicki","Biskupice, gm.","121901",6319,3631,3629,3598,2608,990
"małopolskie","wielicki","Gdów, gm.","121902",11887,6252,6251,6218,4191,2027
"małopolskie","wielicki","Kłaj, gm.","121903",7504,4189,4189,4161,2406,1755
"małopolskie","wielicki","Niepołomice, gm.","121904",16704,9220,9215,9143,5520,3623
"małopolskie","wielicki","Wieliczka, gm.","121905",36943,20752,20749,20622,11298,9324
"małopolskie","Kraków","Kraków, m.","126101",598865,374154,374037,371232,165936,205296
"małopolskie","Nowy Sącz","Nowy Sącz, m.","126201",65548,39583,39562,39242,24061,15181
"małopolskie","Tarnów","Tarnów, m.","126301",95222,52953,52943,52466,29043,23423
"mazowieckie","białobrzeski","Białobrzegi, gm.","140101",8173,4100,4099,4063,2530,1533
"mazowieckie","białobrzeski","Promna, gm.","140102",4531,2089,2089,2071,1739,332
"mazowieckie","białobrzeski","Radzanów, gm.","140103",2928,1508,1508,1500,1286,214
"mazowieckie","białobrzeski","Stara Błotnica, gm.","140104",3797,1831,1831,1814,1576,238
"mazowieckie","białobrzeski","Stromiec, gm.","140105",4255,1856,1856,1834,1458,376
"mazowieckie","białobrzeski","Wyśmierzyce, gm.","140106",2211,1058,1058,1052,932,120
"mazowieckie","ciechanowski","Ciechanów, gm.","140202",4610,1798,1798,1788,1325,463
"mazowieckie","ciechanowski","Ciechanów, m.","140201",36994,18391,18385,18140,10580,7560
"mazowieckie","ciechanowski","Glinojeck, gm.","140203",6355,2240,2240,2217,1460,757
"mazowieckie","ciechanowski","Gołymin-Ośrodek, gm.","140204",3193,1282,1282,1267,1063,204
"mazowieckie","ciechanowski","Grudusk, gm.","140205",3136,1463,1462,1451,1184,267
"mazowieckie","ciechanowski","Ojrzeń, gm.","140206",3405,1447,1446,1434,1157,277
"mazowieckie","ciechanowski","Opinogóra Górna, gm.","140207",4605,1819,1819,1794,1452,342
"mazowieckie","ciechanowski","Regimin, gm.","140208",3864,1467,1467,1450,1119,331
"mazowieckie","ciechanowski","Sońsk, gm.","140209",6246,2743,2743,2720,2104,616
"mazowieckie","garwoliński","Borowie, gm.","140303",3899,1957,1957,1936,1637,299
"mazowieckie","garwoliński","Garwolin, gm.","140304",8968,4685,4685,4646,3326,1320
"mazowieckie","garwoliński","Garwolin, m.","140301",12871,7576,7572,7500,4578,2922
"mazowieckie","garwoliński","Górzno, gm.","140305",4658,2666,2666,2660,2168,492
"mazowieckie","garwoliński","Łaskarzew, gm.","140306",3990,2069,2069,2045,1634,411
"mazowieckie","garwoliński","Łaskarzew, m.","140302",3799,2107,2107,2085,1533,552
"mazowieckie","garwoliński","Maciejowice, gm.","140307",5833,2801,2801,2785,2202,583
"mazowieckie","garwoliński","Miastków Kościelny, gm.","140308",3997,2185,2185,2171,1784,387
"mazowieckie","garwoliński","Parysów, gm.","140309",3040,1533,1533,1516,1270,246
"mazowieckie","garwoliński","Pilawa, gm.","140310",7930,4108,4108,4079,2845,1234
"mazowieckie","garwoliński","Sobolew, gm.","140311",6315,3221,3221,3201,2565,636
"mazowieckie","garwoliński","Trojanów, gm.","140312",6028,3249,3249,3215,2771,444
"mazowieckie","garwoliński","Wilga, gm.","140313",4061,1929,1929,1910,1321,589
"mazowieckie","garwoliński","Żelechów, gm.","140314",6555,3354,3354,3324,2618,706
"mazowieckie","gostyniński","Gostynin, gm.","140402",9434,3700,3700,3655,2763,892
"mazowieckie","gostyniński","Gostynin, m.","140401",15671,7598,7598,7486,4567,2919
"mazowieckie","gostyniński","Pacyna, gm.","140403",3273,1420,1420,1403,1183,220
"mazowieckie","gostyniński","Sanniki, gm.","140404",5175,2160,2160,2143,1796,347
"mazowieckie","gostyniński","Szczawin Kośc., gm.","140405",4170,1628,1628,1605,1312,293
"mazowieckie","grodziski","Baranów, gm.","140503",3765,1677,1677,1658,1207,451
"mazowieckie","grodziski","Grodzisk Mazowiecki, gm.","140504",30060,16943,16941,16809,8855,7954
"mazowieckie","grodziski","Jaktorów, gm.","140505",7494,3906,3901,3880,2267,1613
"mazowieckie","grodziski","Milanówek, m.","140501",12564,7789,7784,7732,3533,4199
"mazowieckie","grodziski","Podkowa Leśna, m.","140502",3151,2254,2252,2231,807,1424
"mazowieckie","grodziski","Żabia Wola, gm.","140506",4762,2318,2318,2301,1442,859
"mazowieckie","grójecki","Belsk Duży, gm.","140601",5268,2563,2560,2532,1979,553
"mazowieckie","grójecki","Błędów, gm.","140602",6451,2947,2944,2906,2434,472
"mazowieckie","grójecki","Chynów, gm.","140603",7229,3453,3452,3427,2581,846
"mazowieckie","grójecki","Goszczyn, gm.","140604",2274,1173,1172,1164,1028,136
"mazowieckie","grójecki","Grójec, gm.","140605",18821,9035,9033,8941,5115,3826
"mazowieckie","grójecki","Jasieniec, gm.","140606",4236,1785,1785,1767,1420,347
"mazowieckie","grójecki","Mogielnica, gm.","140607",7478,3526,3526,3487,2786,701
"mazowieckie","grójecki","Nowe Miasto nad Pilicą, gm.","140608",7245,3782,3782,3742,3042,700
"mazowieckie","grójecki","Pniewy, gm.","140609",3514,1634,1634,1624,1329,295
"mazowieckie","grójecki","Warka, gm.","140611",14870,7365,7364,7311,5266,2045
"mazowieckie","kozienicki","Garbatka-Letnisko, gm.","140701",4617,2240,2239,2222,1475,747
"mazowieckie","kozienicki","Głowaczów, gm.","140702",5994,2750,2749,2731,2272,459
"mazowieckie","kozienicki","Gniewoszów, gm.","140703",3439,1509,1508,1495,1172,323
"mazowieckie","kozienicki","Grabów nad Pilicą, gm.","140704",2980,1308,1307,1302,1070,232
"mazowieckie","kozienicki","Kozienice, gm.","140705",25515,12675,12675,12522,8796,3726
"mazowieckie","kozienicki","Magnuszew, gm.","140706",5116,2458,2458,2438,1953,485
"mazowieckie","kozienicki","Sieciechów, gm.","140707",3264,1518,1518,1501,1187,314
"mazowieckie","legionowski","Jabłonna, gm.","140802",9075,5739,5737,5685,2651,3034
"mazowieckie","legionowski","Legionowo, m.","140801",40366,24274,24272,24054,11936,12118
"mazowieckie","legionowski","Nieporęt, gm.","140803",9658,5681,5681,5629,2948,2681
"mazowieckie","legionowski","Serock, gm.","140804",8626,4287,4286,4241,2356,1885
"mazowieckie","legionowski","Wieliszew, gm.","140805",6398,3438,3437,3400,1999,1401
"mazowieckie","lipski","Chotcza, gm.","140901",2244,714,714,710,571,139
"mazowieckie","lipski","Ciepielów, gm.","140902",4681,1901,1901,1866,1470,396
"mazowieckie","lipski","Lipsko, gm.","140903",9872,3860,3860,3829,2733,1096
"mazowieckie","lipski","Rzeczniów, gm.","140904",3875,1598,1598,1578,1296,282
"mazowieckie","lipski","Sienno, gm.","140905",5213,1955,1954,1939,1518,421
"mazowieckie","lipski","Solec nad Wisłą, gm.","140906",4689,1527,1526,1505,995,510
"mazowieckie","łosicki","Huszlew, gm.","141001",2501,1268,1268,1256,1113,143
"mazowieckie","łosicki","Łosice, gm.","141002",8947,4564,4563,4500,3320,1180
"mazowieckie","łosicki","Olszanka, gm.","141003",2562,1368,1368,1359,1239,120
"mazowieckie","łosicki","Platerów, gm.","141004",4209,1973,1973,1961,1587,374
"mazowieckie","łosicki","Sarnaki, gm.","141005",4293,2030,2030,2008,1616,392
"mazowieckie","łosicki","Stara Kornica, gm.","141006",3918,2071,2069,2052,1794,258
"mazowieckie","makowski","Czerwonka, gm.","141102",2045,893,893,886,779,107
"mazowieckie","makowski","Karniewo, gm.","141103",4116,1831,1831,1806,1539,267
"mazowieckie","makowski","Krasnosielc, gm.","141104",5216,2295,2295,2267,1686,581
"mazowieckie","makowski","Maków Mazowiecki, m.","141101",8179,3695,3693,3649,2308,1341
"mazowieckie","makowski","Młynarze, gm.","141105",1369,665,665,658,561,97
"mazowieckie","makowski","Płoniawy-Bramura, gm.","141106",4679,1989,1989,1970,1657,313
"mazowieckie","makowski","Różan, gm.","141107",3631,1558,1558,1550,1184,366
"mazowieckie","makowski","Rzewnie, gm.","141108",2198,1088,1088,1078,950,128
"mazowieckie","makowski","Sypniewo, gm.","141109",2845,1411,1411,1398,1176,222
"mazowieckie","makowski","Szelków, gm.","141110",2994,1418,1418,1398,1175,223
"mazowieckie","miński","Cegłów, gm.","141204",5112,2558,2557,2487,1527,960
"mazowieckie","miński","Dębe Wielkie, gm.","141205",6335,3210,3210,3158,2188,970
"mazowieckie","miński","Dobre, gm.","141206",4681,2013,2013,1962,1465,497
"mazowieckie","miński","Halinów, gm.","141207",9026,5221,5221,5158,3248,1910
"mazowieckie","miński","Jakubów, gm.","141208",3810,1796,1795,1759,1408,351
"mazowieckie","miński","Kałuszyn, gm.","141209",4742,2357,2357,2321,1692,629
"mazowieckie","miński","Latowicz, gm.","141210",4374,1806,1805,1771,1410,361
"mazowieckie","miński","Mińsk Mazowiecki, gm.","141211",9601,4864,4863,4808,3211,1597
"mazowieckie","miński","Mińsk Mazowiecki, m.","141201",29413,17051,17048,16829,8536,8293
"mazowieckie","miński","Mrozy, gm.","141212",6997,3257,3256,3227,2176,1051
"mazowieckie","miński","Siennica, gm.","141213",5378,2331,2331,2290,1536,754
"mazowieckie","miński","Stanisławów, gm.","141214",4843,2428,2428,2398,1811,587
"mazowieckie","miński","Sulejówek, m.","141215",14431,9163,9161,9089,4962,4127
"mazowieckie","mławski","Dzierzgowo, gm.","141302",2750,1037,1037,1032,854,178
"mazowieckie","mławski","Lipowiec Kościelny, gm.","141303",3814,1394,1394,1386,1024,362
"mazowieckie","mławski","Mława, m.","141301",24018,11166,11165,11038,6430,4608
"mazowieckie","mławski","Radzanów, gm.","141304",2825,1282,1282,1262,1006,256
"mazowieckie","mławski","Strzegowo, gm.","141305",6310,2579,2579,2552,1959,593
"mazowieckie","mławski","Stupsk, gm.","141306",3947,1618,1618,1600,1238,362
"mazowieckie","mławski","Szreńsk, gm.","141307",3467,1381,1381,1359,1036,323
"mazowieckie","mławski","Szydłowo, gm.","141308",3623,1397,1397,1371,1036,335
"mazowieckie","mławski","Wieczfnia Kościelna, gm.","141309",3191,1298,1298,1285,1039,246
"mazowieckie","mławski","Wiśniewo, gm.","141310",4016,1638,1638,1610,1207,403
"mazowieckie","nowodworski","Czosnów, gm.","141402",7029,3700,3700,3650,2208,1442
"mazowieckie","nowodworski","Leoncin, gm.","141403",4017,1956,1956,1937,1385,552
"mazowieckie","nowodworski","Nasielsk, gm.","141404",14832,6639,6639,6585,4680,1905
"mazowieckie","nowodworski","Nowy Dwór Mazowiecki, m.","141401",21947,11251,11251,11110,5692,5418
"mazowieckie","nowodworski","Pomiechówek, gm.","141405",6948,3605,3604,3574,2356,1218
"mazowieckie","nowodworski","Zakroczym, gm.","141406",4904,2102,2102,2078,1336,742
"mazowieckie","ostrołęcki","Baranowo, gm.","141501",5349,2284,2284,2272,1642,630
"mazowieckie","ostrołęcki","Czarnia, gm.","141502",2054,809,809,799,641,158
"mazowieckie","ostrołęcki","Czerwin, gm.","141503",4212,1946,1946,1926,1744,182
"mazowieckie","ostrołęcki","Goworowo, gm.","141504",6967,2640,2640,2614,2146,468
"mazowieckie","ostrołęcki","Kadzidło, gm.","141505",8188,3751,3751,3723,2799,924
"mazowieckie","ostrołęcki","Lelis, gm.","141506",5983,3034,3034,2987,2422,565
"mazowieckie","ostrołęcki","Łyse, gm.","141507",6084,2363,2363,2349,1695,654
"mazowieckie","ostrołęcki","Myszyniec, gm.","141508",7942,3616,3616,3573,2730,843
"mazowieckie","ostrołęcki","Olszewo-Borki, gm.","141509",6803,3375,3375,3346,2473,873
"mazowieckie","ostrołęcki","Rzekuń, gm.","141510",6556,3150,3150,3133,2430,703
"mazowieckie","ostrołęcki","Troszyn, gm.","141511",3936,1941,1941,1926,1680,246
"mazowieckie","ostrowski","Andrzejewo, gm.","141602",3557,1940,1940,1920,1797,123
"mazowieckie","ostrowski","Boguty-Pianki, gm.","141603",2310,1383,1383,1371,1270,101
"mazowieckie","ostrowski","Brok, gm.","141604",2275,1226,1226,1221,893,328
"mazowieckie","ostrowski","Małkinia Górna, gm.","141605",9702,4837,4837,4799,3752,1047
"mazowieckie","ostrowski","Nur, gm.","141606",2695,1487,1487,1482,1334,148
"mazowieckie","ostrowski","Ostrów Mazowiecka, gm.","141607",9728,4527,4527,4502,3670,832
"mazowieckie","ostrowski","Ostrów Mazowiecka, m.","141601",17975,8653,8651,8580,5860,2720
"mazowieckie","ostrowski","Stary Lubotyń, gm.","141608",3060,1513,1513,1499,1375,124
"mazowieckie","ostrowski","Szulborze Wielkie, gm.","141609",1518,778,778,765,697,68
"mazowieckie","ostrowski","Wąsewo, gm.","141610",3631,1515,1515,1506,1234,272
"mazowieckie","ostrowski","Zaręby Kościelne, gm.","141611",3114,1559,1559,1546,1371,175
"mazowieckie","otwocki","Celestynów, gm.","141703",8495,5268,5268,5216,3453,1763
"mazowieckie","otwocki","Józefów, m.","141701",13175,8852,8849,8792,4320,4472
"mazowieckie","otwocki","Karczew, gm.","141704",12629,7460,7460,7394,4544,2850
"mazowieckie","otwocki","Kołbiel, gm.","141705",6230,3260,3260,3236,2364,872
"mazowieckie","otwocki","Osieck, gm.","141706",2754,1512,1512,1502,1199,303
"mazowieckie","otwocki","Otwock, m.","141702",34134,21274,21271,21088,11478,9610
"mazowieckie","otwocki","Sobienie-Jeziory, gm.","141707",4902,2422,2422,2390,1748,642
"mazowieckie","otwocki","Wiązowna, gm.","141708",6995,4160,4160,4131,2570,1561
"mazowieckie","piaseczyński","Góra Kalwaria, gm.","141801",18923,9380,9374,9291,5287,4004
"mazowieckie","piaseczyński","Konstancin-Jeziorna, gm.","141802",18897,11713,11709,11613,5578,6035
"mazowieckie","piaseczyński","Lesznowola, gm.","141803",11409,7309,7306,7263,3404,3859
"mazowieckie","piaseczyński","Piaseczno, gm.","141804",43643,28287,28277,28057,11698,16359
"mazowieckie","piaseczyński","Prażmów, gm.","141805",6179,3163,3163,3125,1854,1271
"mazowieckie","piaseczyński","Tarczyn, gm.","141806",8174,4322,4322,4274,2914,1360
"mazowieckie","płocki","Bielsk, gm.","141901",6714,2844,2840,2816,2184,632
"mazowieckie","płocki","Bodzanów, gm.","141902",6533,2557,2557,2533,1970,563
"mazowieckie","płocki","Brudzeń Duży, gm.","141903",5901,2465,2463,2443,1910,533
"mazowieckie","płocki","Bulkowo, gm.","141904",4625,1885,1885,1873,1635,238
"mazowieckie","płocki","Drobin, gm.","141905",6614,2215,2215,2188,1579,609
"mazowieckie","płocki","Gąbin, gm.","141906",8525,3900,3900,3869,2882,987
"mazowieckie","płocki","Łąck, gm.","141907",3835,1608,1608,1592,1124,468
"mazowieckie","płocki","Mała Wieś, gm.","141908",4983,1767,1766,1742,1340,402
"mazowieckie","płocki","Nowy Duninów, gm.","141909",3021,1213,1213,1201,816,385
"mazowieckie","płocki","Radzanowo, gm.","141910",5455,2269,2269,2244,1706,538
"mazowieckie","płocki","Słubice, gm.","141911",3609,1578,1577,1565,1292,273
"mazowieckie","płocki","Słupno, gm.","141912",4007,1915,1914,1893,1189,704
"mazowieckie","płocki","Stara Biała, gm.","141913",7284,3290,3288,3260,2315,945
"mazowieckie","płocki","Staroźreby, gm.","141914",5768,2317,2317,2299,1873,426
"mazowieckie","płocki","Wyszogród, gm.","141915",4798,1819,1819,1805,1270,535
"mazowieckie","płoński","Baboszewo, gm.","142003",6209,2596,2596,2578,2066,512
"mazowieckie","płoński","Czerwińsk nad Wisłą, gm.","142004",6314,2355,2354,2340,1886,454
"mazowieckie","płoński","Dzierzążnia, gm.","142005",3054,1218,1218,1208,1040,168
"mazowieckie","płoński","Joniec, gm.","142006",2057,899,899,896,702,194
"mazowieckie","płoński","Naruszewo, gm.","142007",5346,1776,1776,1768,1438,330
"mazowieckie","płoński","Nowe Miasto, gm.","142008",3789,1590,1590,1561,1097,464
"mazowieckie","płoński","Płońsk, gm.","142009",5409,1899,1899,1879,1411,468
"mazowieckie","płoński","Płońsk, m.","142001",18094,8893,8890,8804,5198,3606
"mazowieckie","płoński","Raciąż, gm.","142010",7039,2529,2529,2510,2127,383
"mazowieckie","płoński","Raciąż, m.","142002",3643,1804,1804,1789,1144,645
"mazowieckie","płoński","Sochocin, gm.","142011",4652,1872,1872,1864,1385,479
"mazowieckie","płoński","Załuski, gm.","142012",4319,1663,1663,1652,1387,265
"mazowieckie","pruszkowski","Brwinów, gm.","142103",16500,10177,10171,10078,4866,5212
"mazowieckie","pruszkowski","Michałowice, gm.","142104",11524,7789,7788,7719,3263,4456
"mazowieckie","pruszkowski","Nadarzyn, gm.","142105",7322,4301,4300,4266,2189,2077
"mazowieckie","pruszkowski","Piastów, m.","142101",18891,12126,12113,12031,6242,5789
"mazowieckie","pruszkowski","Pruszków, m.","142102",44302,27145,27137,26929,13169,13760
"mazowieckie","pruszkowski","Raszyn, gm.","142106",15254,9701,9699,9629,5432,4197
"mazowieckie","przasnyski","Chorzele, gm.","142202",8030,3523,3523,3500,2476,1024
"mazowieckie","przasnyski","Czernice Borowe, gm.","142203",3115,1344,1344,1329,1070,259
"mazowieckie","przasnyski","Jednorożec, gm.","142204",5505,2218,2217,2188,1565,623
"mazowieckie","przasnyski","Krasne, gm.","142205",3162,1208,1208,1188,936,252
"mazowieckie","przasnyski","Krzynowłoga Mała, gm.","142206",2821,1461,1461,1460,1298,162
"mazowieckie","przasnyski","Przasnysz, gm.","142207",5610,2442,2442,2418,2006,412
"mazowieckie","przasnyski","Przasnysz, m.","142201",13739,6546,6545,6481,4198,2283
"mazowieckie","przysuski","Borkowice, gm.","142301",3752,1594,1592,1557,1115,442
"mazowieckie","przysuski","Gielniów, gm.","142302",3979,1906,1906,1880,1542,338
"mazowieckie","przysuski","Klwów, gm.","142303",2899,1621,1621,1607,1417,190
"mazowieckie","przysuski","Odrzywół, gm.","142304",3343,1988,1987,1979,1788,191
"mazowieckie","przysuski","Potworów, gm.","142305",3326,1558,1558,1545,1361,184
"mazowieckie","przysuski","Przysucha, gm.","142306",10332,5044,5044,4982,3656,1326
"mazowieckie","przysuski","Rusinów, gm.","142307",3517,1944,1944,1931,1694,237
"mazowieckie","przysuski","Wieniawa, gm.","142308",4295,2069,2068,2051,1706,345
"mazowieckie","pułtuski","Gzy, gm.","142401",3161,1301,1301,1287,1080,207
"mazowieckie","pułtuski","Obryte, gm.","142402",3799,2023,2023,1990,1675,315
"mazowieckie","pułtuski","Pokrzywnica, gm.","142403",3579,1494,1494,1483,1196,287
"mazowieckie","pułtuski","Pułtusk, gm.","142404",18524,9219,9214,9114,5796,3318
"mazowieckie","pułtuski","Świercze, gm.","142405",3647,1428,1427,1413,1103,310
"mazowieckie","pułtuski","Winnica, gm.","142406",3146,1489,1489,1470,1245,225
"mazowieckie","pułtuski","Zatory, gm.","142407",3620,1890,1890,1873,1631,242
"mazowieckie","radomski","Gózd, gm.","142502",5679,2898,2897,2874,2476,398
"mazowieckie","radomski","Iłża, gm.","142503",12727,5106,5106,5061,3535,1526
"mazowieckie","radomski","Jastrzębia, gm.","142504",4805,2456,2456,2433,1955,478
"mazowieckie","radomski","Jedlińsk, gm.","142505",9654,4680,4679,4646,3662,984
"mazowieckie","radomski","Jedlnia-Letnisko, gm.","142506",8686,4532,4531,4503,3378,1125
"mazowieckie","radomski","Kowala, gm.","142507",7601,3821,3821,3786,2945,841
"mazowieckie","radomski","Pionki, gm.","142508",7654,3340,3340,3300,2548,752
"mazowieckie","radomski","Pionki, m.","142501",16885,8224,8219,8160,4716,3444
"mazowieckie","radomski","Przytyk, gm.","142509",5198,2660,2660,2644,2301,343
"mazowieckie","radomski","Skaryszew, gm.","142510",9796,4955,4955,4925,4051,874
"mazowieckie","radomski","Wierzbica, gm.","142511",7896,3389,3388,3353,2527,826
"mazowieckie","radomski","Wolanów, gm.","142512",5990,3088,3088,3074,2511,563
"mazowieckie","radomski","Zakrzew, gm.","142513",8042,4295,4293,4263,3500,763
"mazowieckie","siedlecki","Domanice, gm.","142601",2030,1245,1244,1236,1158,78
"mazowieckie","siedlecki","Korczew, gm.","142602",2495,1249,1249,1241,1040,201
"mazowieckie","siedlecki","Kotuń, gm.","142603",6449,3082,3082,3055,2230,825
"mazowieckie","siedlecki","Mokobody, gm.","142604",3950,2094,2094,2080,1822,258
"mazowieckie","siedlecki","Mordy, gm.","142605",5012,2417,2417,2388,1952,436
"mazowieckie","siedlecki","Paprotnia, gm.","142606",2186,1308,1308,1303,1224,79
"mazowieckie","siedlecki","Przesmyki, gm.","142607",2971,1637,1637,1626,1463,163
"mazowieckie","siedlecki","Siedlce, gm.","142608",11735,5981,5979,5949,4550,1399
"mazowieckie","siedlecki","Skórzec, gm.","142609",5391,2793,2793,2777,2276,501
"mazowieckie","siedlecki","Suchożebry, gm.","142610",3657,1815,1815,1801,1491,310
"mazowieckie","siedlecki","Wiśniew, gm.","142611",4299,2511,2511,2497,2250,247
"mazowieckie","siedlecki","Wodynie, gm.","142612",3725,1768,1768,1754,1441,313
"mazowieckie","siedlecki","Zbuczyn, gm.","142613",7581,4409,4409,4369,3875,494
"mazowieckie","sierpecki","Gozdowo, gm.","142702",4587,1597,1597,1583,1220,363
"mazowieckie","sierpecki","Mochowo, gm.","142703",4702,1771,1771,1755,1382,373
"mazowieckie","sierpecki","Rościszewo, gm.","142704",3268,1569,1569,1553,1343,210
"mazowieckie","sierpecki","Sierpc, gm.","142705",5323,2040,2038,2022,1562,460
"mazowieckie","sierpecki","Sierpc, m.","142701",15422,7390,7387,7331,4442,2889
"mazowieckie","sierpecki","Szczutowo, gm.","142706",3441,1386,1386,1379,1042,337
"mazowieckie","sierpecki","Zawidz, gm.","142707",5425,2311,2310,2291,1870,421
"mazowieckie","sochaczewski","Brochów, gm.","142802",3281,1322,1322,1308,1021,287
"mazowieckie","sochaczewski","Iłów, gm.","142803",4872,2276,2275,2260,1913,347
"mazowieckie","sochaczewski","Młodzieszyn, gm.","142804",4317,1621,1621,1607,1287,320
"mazowieckie","sochaczewski","Nowa Sucha, gm.","142805",4613,2032,2032,2022,1574,448
"mazowieckie","sochaczewski","Rybno, gm.","142806",2726,1247,1247,1231,1072,159
"mazowieckie","sochaczewski","Sochaczew, gm.","142807",6657,2938,2937,2913,2208,705
"mazowieckie","sochaczewski","Sochaczew, m.","142801",30819,15341,15339,15178,8421,6757
"mazowieckie","sochaczewski","Teresin, gm.","142808",8455,4343,4342,4305,2956,1349
"mazowieckie","sokołowski","Bielany, gm.","142902",3085,1789,1789,1782,1634,148
"mazowieckie","sokołowski","Ceranów, gm.","142903",2107,1090,1090,1080,964,116
"mazowieckie","sokołowski","Jabłonna Lacka, gm.","142904",4161,2182,2182,2152,1845,307
"mazowieckie","sokołowski","Kosów Lacki, gm.","142905",5618,2874,2874,2850,2441,409
"mazowieckie","sokołowski","Repki, gm.","142906",4787,2639,2639,2616,2265,351
"mazowieckie","sokołowski","Sabnie, gm.","142907",3329,1884,1884,1857,1502,355
"mazowieckie","sokołowski","Sokołów Podlaski, gm.","142908",4975,2511,2511,2486,2044,442
"mazowieckie","sokołowski","Sokołów Podlaski, m.","142901",14817,7995,7995,7906,5164,2742
"mazowieckie","sokołowski","Sterdyń, gm.","142909",3947,1952,1952,1928,1573,355
"mazowieckie","szydłowiecki","Chlewiska, gm.","143001",5119,2304,2303,2268,1679,589
"mazowieckie","szydłowiecki","Jastrząb, gm.","143002",3883,1731,1731,1710,1357,353
"mazowieckie","szydłowiecki","Mirów, gm.","143003",2872,1278,1277,1268,1105,163
"mazowieckie","szydłowiecki","Orońsko, gm.","143004",4361,2132,2132,2119,1686,433
"mazowieckie","szydłowiecki","Szydłowiec, gm.","143005",15547,7327,7324,7249,5176,2073
"mazowieckie","warszawski zachodni","Błonie, gm.","143201",15767,8575,8571,8502,4697,3805
"mazowieckie","warszawski zachodni","Izabelin, gm.","143202",7046,4689,4688,4669,2278,2391
"mazowieckie","warszawski zachodni","Kampinos, gm.","143203",3046,1449,1449,1438,987,451
"mazowieckie","warszawski zachodni","Leszno, gm.","143204",6790,3311,3311,3289,1808,1481
"mazowieckie","warszawski zachodni","Łomianki, gm.","143205",15735,10701,10694,10625,4841,5784
"mazowieckie","warszawski zachodni","Ożarów Mazowiecki, gm.","143206",15768,8892,8880,8812,5046,3766
"mazowieckie","warszawski zachodni","Stare Babice, gm.","143207",10877,6538,6534,6484,3263,3221
"mazowieckie","węgrowski","Grębków, gm.","143302",3738,1553,1553,1537,1304,233
"mazowieckie","węgrowski","Korytnica, gm.","143303",5405,2593,2593,2565,2183,382
"mazowieckie","węgrowski","Liw, gm.","143304",6042,2948,2948,2917,2265,652
"mazowieckie","węgrowski","Łochów, gm.","143305",13850,6853,6852,6794,5087,1707
"mazowieckie","węgrowski","Miedzna, gm.","143306",3547,1860,1860,1847,1593,254
"mazowieckie","węgrowski","Sadowne, gm.","143307",5006,2310,2310,2278,1791,487
"mazowieckie","węgrowski","Stoczek, gm.","143308",4297,2143,2143,2135,1752,383
"mazowieckie","węgrowski","Węgrów, m.","143301",10184,5468,5467,5378,3200,2178
"mazowieckie","węgrowski","Wierzbno, gm.","143309",2588,1259,1259,1237,1058,179
"mazowieckie","wołomiński","Dąbrówka, gm.","143405",5080,2822,2822,2803,2380,423
"mazowieckie","wołomiński","Jadów, gm.","143406",6121,2689,2689,2667,1936,731
"mazowieckie","wołomiński","Klembów, gm.","143407",6513,3557,3557,3540,2610,930
"mazowieckie","wołomiński","Kobyłka, m.","143401",13163,8485,8482,8419,5216,3203
"mazowieckie","wołomiński","Marki, m.","143402",16378,9241,9240,9201,5455,3746
"mazowieckie","wołomiński","Poświętne, gm.","143408",4395,2187,2187,2171,1830,341
"mazowieckie","wołomiński","Radzymin, gm.","143409",14345,8230,8228,8175,5771,2404
"mazowieckie","wołomiński","Strachówka, gm.","143410",2483,976,976,967,773,194
"mazowieckie","wołomiński","Tłuszcz, gm.","143411",14029,7333,7330,7270,5017,2253
"mazowieckie","wołomiński","Wołomin, gm.","143412",38429,23759,23754,23572,14337,9235
"mazowieckie","wołomiński","Ząbki, m.","143403",16993,10657,10653,10600,5819,4781
"mazowieckie","wołomiński","Zielonka, m.","143404",12926,8600,8597,8508,4827,3681
"mazowieckie","wyszkowski","Brańszczyk, gm.","143501",6491,3271,3271,3253,2644,609
"mazowieckie","wyszkowski","Długosiodło, gm.","143502",6004,2612,2612,2592,1966,626
"mazowieckie","wyszkowski","Rząśnik, gm.","143503",5070,2715,2715,2695,2366,329
"mazowieckie","wyszkowski","Somianka, gm.","143504",4375,2204,2204,2192,1807,385
"mazowieckie","wyszkowski","Wyszków, gm.","143505",28887,15620,15617,15484,10386,5098
"mazowieckie","wyszkowski","Zabrodzie, gm.","143506",4232,2038,2038,2023,1610,413
"mazowieckie","zwoleński","Kazanów, gm.","143601",3650,1676,1676,1657,1359,298
"mazowieckie","zwoleński","Policzna, gm.","143602",4690,1938,1938,1917,1560,357
"mazowieckie","zwoleński","Przyłęk, gm.","143603",5123,2153,2153,2136,1820,316
"mazowieckie","zwoleński","Tczów, gm.","143604",3700,1715,1715,1699,1476,223
"mazowieckie","zwoleński","Zwoleń, gm.","143605",12212,5983,5982,5907,4391,1516
"mazowieckie","żuromiński","Bieżuń, gm.","143701",4274,1747,1747,1738,1342,396
"mazowieckie","żuromiński","Kuczbork-Osada, gm.","143702",4027,1594,1594,1576,1158,418
"mazowieckie","żuromiński","Lubowidz, gm.","143703",5807,2397,2397,2383,1730,653
"mazowieckie","żuromiński","Lutocin, gm.","143704",3691,1522,1522,1519,1282,237
"mazowieckie","żuromiński","Siemiątkowo, gm.","143705",2934,1018,1018,1001,814,187
"mazowieckie","żuromiński","Żuromin, gm.","143706",11371,4940,4939,4878,3224,1654
"mazowieckie","żyrardowski","Mszczonów, gm.","143802",8791,3892,3892,3853,2641,1212
"mazowieckie","żyrardowski","Puszcza Mariańska, gm.","143803",6372,2895,2895,2861,1910,951
"mazowieckie","żyrardowski","Radziejowice, gm.","143804",3510,1733,1733,1711,1132,579
"mazowieckie","żyrardowski","Wiskitki, gm.","143805",7233,3327,3327,3299,2375,924
"mazowieckie","żyrardowski","Żyrardów, m.","143801",32976,17537,17533,17343,8967,8376
"mazowieckie","Ostrołęka","Ostrołęka, m.","146101",42792,22278,22275,22060,13777,8283
"mazowieckie","Płock","Płock, m.","146201",102266,55226,55207,54559,29523,25036
"mazowieckie","Radom","Radom, m.","146301",180848,101698,101667,100728,60136,40592
"mazowieckie","Siedlce","Siedlce, m.","146401",60166,34209,34200,33839,20497,13342
"mazowieckie","Warszawa","Warszawa, m.","146501",1359912,900924,900252,890522,359203,531319
"mazowieckie","Zagranica","Zagranica","149901",80071,48196,48179,47796,21418,26378
"opolskie","brzeski","Brzeg, m.","160101",31379,16167,16162,15999,7808,8191
"opolskie","brzeski","Grodków, gm.","160103",15526,6393,6393,6337,3173,3164
"opolskie","brzeski","Lewin Brzeski, gm.","160104",10393,4670,4669,4627,2350,2277
"opolskie","brzeski","Lubsza, gm.","160105",6816,3024,3024,3009,1794,1215
"opolskie","brzeski","Olszanka, gm.","160106",3844,1801,1801,1784,1139,645
"opolskie","brzeski","Skarbimierz, gm.","160102",5190,2582,2582,2564,1656,908
"opolskie","głubczycki","Baborów, gm.","160201",5202,1772,1772,1756,854,902
"opolskie","głubczycki","Branice, gm.","160202",6164,2447,2447,2392,1258,1134
"opolskie","głubczycki","Głubczyce, gm.","160203",19520,9125,9125,9030,4658,4372
"opolskie","głubczycki","Kietrz, gm.","160204",9242,4330,4329,4289,2340,1949
"opolskie","kędzierzyńsko-kozielski","Bierawa, gm.","160302",6254,2200,2200,2185,707,1478
"opolskie","kędzierzyńsko-kozielski","Cisek, gm.","160303",5086,1519,1519,1501,448,1053
"opolskie","kędzierzyńsko-kozielski","Kędzierzyn-Koźle, m.","160301",51985,24936,24932,24676,8914,15762
"opolskie","kędzierzyńsko-kozielski","Pawłowiczki, gm.","160304",6897,2117,2117,2095,867,1228
"opolskie","kędzierzyńsko-kozielski","Polska Cerekiew, gm.","160305",3805,1154,1154,1141,299,842
"opolskie","kędzierzyńsko-kozielski","Reńska Wieś, gm.","160306",6863,2157,2157,2147,689,1458
"opolskie","kluczborski","Byczyna, gm.","160401",7584,3008,3008,2986,1591,1395
"opolskie","kluczborski","Kluczbork, gm.","160402",31059,13446,13444,13346,5838,7508
"opolskie","kluczborski","Lasowice Wielkie, gm.","160403",5748,1743,1743,1727,519,1208
"opolskie","kluczborski","Wołczyn, gm.","160404",11116,4793,4793,4735,2604,2131
"opolskie","krapkowicki","Gogolin, gm.","160501",10094,3154,3154,3133,927,2206
"opolskie","krapkowicki","Krapkowice, gm.","160502",19620,7555,7553,7486,2296,5190
"opolskie","krapkowicki","Strzeleczki, gm.","160503",6259,2016,2016,1989,377,1612
"opolskie","krapkowicki","Walce, gm.","160504",4742,1418,1418,1403,327,1076
"opolskie","krapkowicki","Zdzieszowice, gm.","160505",13379,4922,4921,4869,1396,3473
"opolskie","namysłowski","Domaszowice, gm.","160601",3007,1523,1523,1500,861,639
"opolskie","namysłowski","Namysłów, gm.","160602",20867,9958,9956,9885,5088,4797
"opolskie","namysłowski","Pokój, gm.","160603",4259,1582,1582,1566,572,994
"opolskie","namysłowski","Świerczów, gm.","160604",2852,1403,1403,1386,748,638
"opolskie","namysłowski","Wilków, gm.","160605",3557,1526,1526,1515,836,679
"opolskie","nyski","Głuchołazy, gm.","160701",21183,9533,9529,9445,4658,4787
"opolskie","nyski","Kamiennik, gm.","160702",2974,1335,1335,1324,842,482
"opolskie","nyski","Korfantów, gm.","160703",7815,2719,2719,2694,1470,1224
"opolskie","nyski","Łambinowice, gm.","160704",6192,2549,2549,2525,1358,1167
"opolskie","nyski","Nysa, gm.","160705",49397,23948,23944,23750,11628,12122
"opolskie","nyski","Otmuchów, gm.","160706",11530,5233,5230,5161,2860,2301
"opolskie","nyski","Paczków, gm.","160707",10960,4926,4925,4878,2644,2234
"opolskie","nyski","Pakosławice, gm.","160708",3006,1386,1386,1374,835,539
"opolskie","nyski","Skoroszyce, gm.","160709",5036,1993,1992,1963,1121,842
"opolskie","oleski","Dobrodzień, gm.","160801",8410,2631,2631,2599,822,1777
"opolskie","oleski","Gorzów Śląski, gm.","160802",6024,1836,1836,1814,827,987
"opolskie","oleski","Olesno, gm.","160803",15051,5716,5716,5672,2101,3571
"opolskie","oleski","Praszka, gm.","160804",11509,5078,5075,4993,2599,2394
"opolskie","oleski","Radłów, gm.","160805",3560,989,989,978,419,559
"opolskie","oleski","Rudniki, gm.","160806",6782,2766,2765,2738,1713,1025
"opolskie","oleski","Zębowice, gm.","160807",3234,908,908,902,356,546
"opolskie","opolski","Chrząstowice, gm.","160901",5227,1797,1797,1786,508,1278
"opolskie","opolski","Dąbrowa, gm.","160902",7266,3018,3018,2992,978,2014
"opolskie","opolski","Dobrzeń Wielki, gm.","160903",11066,4035,4035,4002,1136,2866
"opolskie","opolski","Komprachcice, gm.","160904",8663,3118,3118,3083,813,2270
"opolskie","opolski","Łubniany, gm.","160905",7410,2390,2389,2370,557,1813
"opolskie","opolski","Murów, gm.","160906",4704,1464,1464,1451,342,1109
"opolskie","opolski","Niemodlin, gm.","160907",10707,4596,4595,4556,2129,2427
"opolskie","opolski","Ozimek, gm.","160908",17071,5874,5874,5827,1940,3887
"opolskie","opolski","Popielów, gm.","160909",6768,2241,2241,2216,774,1442
"opolskie","opolski","Prószków, gm.","160910",7769,2749,2748,2729,714,2015
"opolskie","opolski","Tarnów Opolski, gm.","160911",7791,2829,2829,2815,831,1984
"opolskie","opolski","Tułowice, gm.","160912",4242,1869,1869,1851,794,1057
"opolskie","opolski","Turawa, gm.","160913",7675,2623,2623,2602,667,1935
"opolskie","prudnicki","Biała, gm.","161001",9205,2803,2802,2783,926,1857
"opolskie","prudnicki","Głogówek, gm.","161002",11239,4109,4109,4086,1592,2494
"opolskie","prudnicki","Lubrza, gm.","161003",3501,1623,1623,1609,871,738
"opolskie","prudnicki","Prudnik, gm.","161004",23539,11598,11594,11483,6099,5384
"opolskie","strzelecki","Izbicko, gm.","161101",4212,1575,1574,1565,430,1135
"opolskie","strzelecki","Jemielnica, gm.","161102",5783,1725,1725,1715,681,1034
"opolskie","strzelecki","Kolonowskie, gm.","161103",5126,1669,1668,1657,534,1123
"opolskie","strzelecki","Leśnica, gm.","161104",6741,2303,2301,2284,855,1429
"opolskie","strzelecki","Strzelce Opolskie, gm.","161105",27989,10740,10738,10645,3602,7043
"opolskie","strzelecki","Ujazd, gm.","161106",4907,1901,1901,1887,758,1129
"opolskie","strzelecki","Zawadzkie, gm.","161107",10323,3582,3582,3558,1530,2028
"opolskie","Opole","Opole, m.","166101",100565,54590,54578,53991,17883,36108
"podkarpackie","bieszczadzki","Czarna, gm.","180103",1854,791,791,787,478,309
"podkarpackie","bieszczadzki","Lutowiska, gm.","180105",1731,750,750,742,352,390
"podkarpackie","bieszczadzki","Ustrzyki Dolne, gm.","180108",13957,5957,5957,5905,3631,2274
"podkarpackie","brzozowski","Brzozów, gm.","180201",20212,10265,10262,10179,7881,2298
"podkarpackie","brzozowski","Domaradz, gm.","180202",4628,2455,2455,2438,2106,332
"podkarpackie","brzozowski","Dydnia, gm.","180203",6249,2853,2853,2827,2283,544
"podkarpackie","brzozowski","Haczów, gm.","180204",7113,3670,3669,3651,2960,691
"podkarpackie","brzozowski","Jasienica Rosielna, gm.","180205",5419,3490,3487,3470,3126,344
"podkarpackie","brzozowski","Nozdrzec, gm.","180206",6727,3183,3183,3142,2438,704
"podkarpackie","dębicki","Brzostek, gm.","180302",9699,4954,4954,4913,4103,810
"podkarpackie","dębicki","Czarna, gm.","180303",9341,5176,5176,5143,4237,906
"podkarpackie","dębicki","Dębica, gm.","180304",17914,9817,9815,9754,7620,2134
"podkarpackie","dębicki","Dębica, m.","180301",37935,21792,21789,21589,14048,7541
"podkarpackie","dębicki","Jodłowa, gm.","180305",4166,1895,1895,1883,1616,267
"podkarpackie","dębicki","Pilzno, gm.","180306",12929,7512,7511,7470,6325,1145
"podkarpackie","dębicki","Żyraków, gm.","180307",9914,5403,5403,5373,4403,970
"podkarpackie","jarosławski","Chłopice, gm.","180403",4316,2273,2273,2260,1953,307
"podkarpackie","jarosławski","Jarosław, gm.","180404",9685,5066,5066,5038,4086,952
"podkarpackie","jarosławski","Jarosław, m.","180401",32383,17502,17500,17362,11253,6109
"podkarpackie","jarosławski","Laszki, gm.","180405",5358,2820,2820,2791,2250,541
"podkarpackie","jarosławski","Pawłosiów, gm.","180406",6155,3445,3445,3412,2770,642
"podkarpackie","jarosławski","Pruchnik, gm.","180407",7117,4096,4096,4054,3487,567
"podkarpackie","jarosławski","Radymno, gm.","180408",8650,4237,4237,4200,3538,662
"podkarpackie","jarosławski","Radymno, m.","180402",4292,2333,2333,2321,1685,636
"podkarpackie","jarosławski","Rokietnica, gm.","180409",3358,1566,1566,1551,1353,198
"podkarpackie","jarosławski","Roźwienica, gm.","180410",4810,2495,2494,2475,2127,348
"podkarpackie","jarosławski","Wiązownica, gm.","180411",8332,4919,4919,4890,4168,722
"podkarpackie","jasielski","Brzyska, gm.","180502",4707,2428,2428,2413,2118,295
"podkarpackie","jasielski","Dębowiec, gm.","180503",6339,3461,3461,3441,2874,567
"podkarpackie","jasielski","Jasło, gm.","180504",12450,7028,7028,6965,5428,1537
"podkarpackie","jasielski","Jasło, m.","180501",30651,16126,16126,15978,10254,5724
"podkarpackie","jasielski","Kołaczyce, gm.","180505",6588,3502,3501,3477,2833,644
"podkarpackie","jasielski","Krempna, gm.","180506",1557,618,618,616,439,177
"podkarpackie","jasielski","Nowy Żmigród, gm.","180507",7195,3807,3807,3788,3172,616
"podkarpackie","jasielski","Osiek Jasielski, gm.","180508",3991,1839,1839,1829,1520,309
"podkarpackie","jasielski","Skołyszyn, gm.","180509",9522,4952,4952,4917,3693,1224
"podkarpackie","jasielski","Tarnowiec, gm.","180511",7095,3412,3412,3391,2659,732
"podkarpackie","kolbuszowski","Cmolas, gm.","180601",5811,3082,3082,3077,2644,433
"podkarpackie","kolbuszowski","Dzikowiec, gm.","180606",4913,2185,2185,2161,1863,298
"podkarpackie","kolbuszowski","Kolbuszowa, gm.","180602",18922,9657,9653,9583,7250,2333
"podkarpackie","kolbuszowski","Majdan Królewski, gm.","180603",7328,3878,3875,3854,3262,592
"podkarpackie","kolbuszowski","Niwiska, gm.","180604",4317,2159,2159,2143,1820,323
"podkarpackie","kolbuszowski","Raniżów, gm.","180605",5348,2938,2938,2917,2484,433
"podkarpackie","krośnieński","Chorkówka, gm.","180701",9952,5279,5279,5248,4103,1145
"podkarpackie","krośnieński","Dukla, gm.","180702",12786,6109,6109,6041,4509,1532
"podkarpackie","krośnieński","Iwonicz-Zdrój, gm.","180703",8327,4918,4917,4894,3595,1299
"podkarpackie","krośnieński","Jedlicze, gm.","180704",11896,5840,5839,5805,4003,1802
"podkarpackie","krośnieński","Korczyna, gm.","180705",8277,4552,4552,4520,3667,853
"podkarpackie","krośnieński","Krościenko Wyżne, gm.","180706",3859,2131,2131,2117,1593,524
"podkarpackie","krośnieński","Miejsce Piastowe, gm.","180707",10149,5683,5681,5650,4129,1521
"podkarpackie","krośnieński","Rymanów, gm.","180708",12328,7027,7026,6976,5207,1769
"podkarpackie","krośnieński","Wojaszówka, gm.","180709",7017,3183,3182,3158,2354,804
"podkarpackie","leżajski","Grodzisko Dolne, gm.","180802",6295,3588,3586,3558,2937,621
"podkarpackie","leżajski","Kuryłówka, gm.","180803",4336,2233,2233,2209,1778,431
"podkarpackie","leżajski","Leżajsk, gm.","180804",14443,7793,7792,7760,6485,1275
"podkarpackie","leżajski","Leżajsk, m.","180801",11742,6257,6250,6202,4096,2106
"podkarpackie","leżajski","Nowa Sarzyna, gm.","180805",16322,9290,9290,9237,7784,1453
"podkarpackie","lubaczowski","Cieszanów, gm.","180902",5881,2833,2833,2793,2169,624
"podkarpackie","lubaczowski","Horyniec-Zdrój, gm.","180903",4042,1880,1880,1856,1269,587
"podkarpackie","lubaczowski","Lubaczów, gm.","180904",6971,3274,3274,3220,2491,729
"podkarpackie","lubaczowski","Lubaczów, m.","180901",9936,4845,4845,4804,2875,1929
"podkarpackie","lubaczowski","Narol, gm.","180905",6748,3286,3286,3253,2480,773
"podkarpackie","lubaczowski","Oleszyce, gm.","180906",5142,2648,2648,2629,1985,644
"podkarpackie","lubaczowski","Stary Dzików, gm.","180907",3581,1742,1742,1712,1469,243
"podkarpackie","lubaczowski","Wielkie Oczy, gm.","180908",3033,1725,1722,1705,1380,325
"podkarpackie","łańcucki","Białobrzegi, gm.","181002",6005,3508,3508,3489,3001,488
"podkarpackie","łańcucki","Czarna, gm.","181003",8054,4855,4854,4837,4116,721
"podkarpackie","łańcucki","Łańcut, gm.","181004",15355,9514,9508,9431,8030,1401
"podkarpackie","łańcucki","Łańcut, m.","181001",14251,8769,8766,8707,6008,2699
"podkarpackie","łańcucki","Markowa, gm.","181005",4952,2647,2647,2631,2256,375
"podkarpackie","łańcucki","Rakszawa, gm.","181006",5365,3367,3366,3347,2861,486
"podkarpackie","łańcucki","Żołynia, gm.","181007",5106,2978,2977,2952,2359,593
"podkarpackie","mielecki","Borowa, gm.","181102",4204,2195,2195,2179,1729,450
"podkarpackie","mielecki","Czermin, gm.","181103",4985,2323,2323,2307,1907,400
"podkarpackie","mielecki","Gawłuszowice, gm.","181104",2187,1185,1185,1175,1020,155
"podkarpackie","mielecki","Mielec, gm.","181105",9088,4754,4753,4718,3660,1058
"podkarpackie","mielecki","Mielec, m.","181101",49392,26097,26093,25848,16228,9620
"podkarpackie","mielecki","Padew Narodowa, gm.","181106",4196,2263,2263,2227,1934,293
"podkarpackie","mielecki","Przecław, gm.","181107",8098,4082,4081,4051,3283,768
"podkarpackie","mielecki","Radomyśl Wielki, gm.","181108",9938,4895,4891,4859,4000,859
"podkarpackie","mielecki","Tuszów Narodowy, gm.","181109",5658,3337,3337,3313,2853,460
"podkarpackie","mielecki","Wadowice Górne, gm.","181110",5225,2579,2579,2559,2217,342
"podkarpackie","niżański","Harasiuki, gm.","181201",4768,2158,2158,2143,1746,397
"podkarpackie","niżański","Jarocin, gm.","181202",4218,1715,1715,1700,1262,438
"podkarpackie","niżański","Jeżowe, gm.","181203",7186,4208,4208,4200,3827,373
"podkarpackie","niżański","Krzeszów, gm.","181204",3342,1521,1520,1510,1257,253
"podkarpackie","niżański","Nisko, gm.","181205",17447,8227,8225,8140,5848,2292
"podkarpackie","niżański","Rudnik nad Sanem, gm.","181206",7906,3656,3656,3631,2535,1096
"podkarpackie","niżański","Ulanów, gm.","181207",6784,3167,3167,3146,2465,681
"podkarpackie","przemyski","Bircza, gm.","181301",5145,2487,2487,2458,1926,532
"podkarpackie","przemyski","Dubiecko, gm.","181302",7516,3457,3457,3436,2654,782
"podkarpackie","przemyski","Fredropol, gm.","181303",4157,1932,1932,1922,1320,602
"podkarpackie","przemyski","Krasiczyn, gm.","181304",3629,1752,1752,1725,1239,486
"podkarpackie","przemyski","Krzywcza, gm.","181305",3760,1845,1845,1835,1537,298
"podkarpackie","przemyski","Medyka, gm.","181306",4886,2746,2745,2726,1876,850
"podkarpackie","przemyski","Orły, gm.","181307",6308,3365,3365,3344,2774,570
"podkarpackie","przemyski","Przemyśl, gm.","181308",7005,3659,3659,3633,2642,991
"podkarpackie","przemyski","Stubno, gm.","181309",3120,1377,1377,1358,967,391
"podkarpackie","przemyski","Żurawica, gm.","181310",9684,5151,5151,5104,3982,1122
"podkarpackie","przeworski","Adamówka, gm.","181402",3160,1473,1473,1462,1165,297
"podkarpackie","przeworski","Gać, gm.","181403",3514,1835,1835,1825,1572,253
"podkarpackie","przeworski","Jawornik Polski, gm.","181404",3846,1832,1832,1812,1505,307
"podkarpackie","przeworski","Kańczuga, gm.","181405",9854,4298,4298,4259,3285,974
"podkarpackie","przeworski","Przeworsk, gm.","181406",11065,6606,6606,6580,5752,828
"podkarpackie","przeworski","Przeworsk, m.","181401",12861,7198,7197,7147,5227,1920
"podkarpackie","przeworski","Sieniawa, gm.","181407",5160,2462,2461,2442,1852,590
"podkarpackie","przeworski","Tryńcza, gm.","181408",6060,3347,3347,3332,2884,448
"podkarpackie","przeworski","Zarzecze, gm.","181409",5401,2774,2774,2756,2328,428
"podkarpackie","ropczycko-sędziszowski","Iwierzyce, gm.","181501",5521,3238,3238,3210,2779,431
"podkarpackie","ropczycko-sędziszowski","Ostrów, gm.","181502",5088,2559,2559,2545,2154,391
"podkarpackie","ropczycko-sędziszowski","Ropczyce, gm.","181503",19755,11257,11253,11166,9082,2084
"podkarpackie","ropczycko-sędziszowski","Sędziszów Małopolski, gm.","181504",17207,10665,10665,10586,8880,1706
"podkarpackie","ropczycko-sędziszowski","Wielopole Skrzyńskie, gm.","181505",6254,3300,3299,3273,2793,480
"podkarpackie","rzeszowski","Błażowa, gm.","181602",8257,4861,4861,4824,4043,781
"podkarpackie","rzeszowski","Boguchwała, gm.","181603",16089,9962,9961,9881,7543,2338
"podkarpackie","rzeszowski","Chmielnik, gm.","181604",4770,2856,2856,2834,2405,429
"podkarpackie","rzeszowski","Dynów, gm.","181605",5541,2581,2581,2570,2065,505
"podkarpackie","rzeszowski","Dynów, m.","181601",4730,2599,2599,2579,1893,686
"podkarpackie","rzeszowski","Głogów Małopolski, gm.","181606",13372,7996,7995,7922,5902,2020
"podkarpackie","rzeszowski","Hyżne, gm.","181607",5106,3273,3273,3259,2802,457
"podkarpackie","rzeszowski","Kamień, gm.","181608",5068,2804,2804,2776,2437,339
"podkarpackie","rzeszowski","Krasne, gm.","181609",11630,7211,7210,7164,4916,2248
"podkarpackie","rzeszowski","Lubenia, gm.","181610",5057,2892,2892,2878,2443,435
"podkarpackie","rzeszowski","Sokołów Małopolski, gm.","181611",12323,7428,7426,7379,6183,1196
"podkarpackie","rzeszowski","Świlcza, gm.","181612",14182,8436,8433,8380,6434,1946
"podkarpackie","rzeszowski","Trzebownisko, gm.","181613",13791,8537,8535,8483,6545,1938
"podkarpackie","rzeszowski","Tyczyn, gm.","181614",11805,7004,7003,6960,5324,1636
"podkarpackie","sanocki","Besko, gm.","181702",3219,1421,1421,1414,1045,369
"podkarpackie","sanocki","Bukowsko, gm.","181703",3887,1911,1911,1899,1447,452
"podkarpackie","sanocki","Komańcza, gm.","181704",4628,1651,1651,1642,648,994
"podkarpackie","sanocki","Sanok, gm.","181705",12785,6007,6007,5968,4617,1351
"podkarpackie","sanocki","Sanok, m.","181701",32407,15788,15783,15646,8998,6648
"podkarpackie","sanocki","Tyrawa Wołoska, gm.","181706",1448,565,564,556,377,179
"podkarpackie","sanocki","Zagórz, gm.","181707",9826,4527,4526,4503,3139,1364
"podkarpackie","sanocki","Zarszyn, gm.","181708",6982,3291,3291,3252,2199,1053
"podkarpackie","stalowowolski","Bojanów, gm.","181802",5262,2585,2584,2561,2164,397
"podkarpackie","stalowowolski","Pysznica, gm.","181803",7150,3361,3361,3315,2675,640
"podkarpackie","stalowowolski","Radomyśl nad Sanem, gm.","181804",5804,2564,2563,2538,1889,649
"podkarpackie","stalowowolski","Stalowa Wola, m.","181801",54173,27784,27780,27517,17349,10168
"podkarpackie","stalowowolski","Zaklików, gm.","181805",6673,2814,2813,2768,1987,781
"podkarpackie","stalowowolski","Zaleszany, gm.","181806",8197,4088,4088,4037,3040,997
"podkarpackie","strzyżowski","Czudec, gm.","181901",8784,5115,5115,5088,4122,966
"podkarpackie","strzyżowski","Frysztak, gm.","181902",7936,4164,4163,4130,3208,922
"podkarpackie","strzyżowski","Niebylec, gm.","181903",8060,4545,4545,4520,3729,791
"podkarpackie","strzyżowski","Strzyżów, gm.","181904",16238,7979,7978,7915,5819,2096
"podkarpackie","strzyżowski","Wiśniowa, gm.","181905",6468,3349,3348,3328,2714,614
"podkarpackie","tarnobrzeski","Baranów Sandomierski, gm.","182001",9222,4803,4803,4761,3658,1103
"podkarpackie","tarnobrzeski","Gorzyce, gm.","182002",10671,4898,4898,4840,3195,1645
"podkarpackie","tarnobrzeski","Grębów, gm.","182003",7328,3354,3353,3325,2586,739
"podkarpackie","tarnobrzeski","Nowa Dęba, gm.","182004",15342,7502,7502,7437,4997,2440
"podkarpackie","leski","Baligród, gm.","182101",2507,1181,1181,1173,852,321
"podkarpackie","leski","Cisna, gm.","182102",1378,641,641,624,270,354
"podkarpackie","leski","Lesko, gm.","182103",9112,4227,4226,4187,2740,1447
"podkarpackie","leski","Olszanica, gm.","182104",4506,2156,2156,2142,1224,918
"podkarpackie","leski","Solina, gm.","182105",4203,2170,2170,2158,1432,726
"podkarpackie","Krosno","Krosno, m.","186101",38742,21077,21070,20895,12252,8643
"podkarpackie","Przemyśl","Przemyśl, m.","186201",54030,28528,28513,28268,16871,11397
"podkarpackie","Rzeszów","Rzeszów, m.","186301",122911,74356,74327,73580,41798,31782
"podkarpackie","Tarnobrzeg","Tarnobrzeg, m.","186401",39137,19786,19785,19620,10871,8749
"podlaskie","augustowski","Augustów, gm.","200102",5210,2116,2116,2091,1701,390
"podlaskie","augustowski","Augustów, m.","200101",23614,11698,11696,11616,6914,4702
"podlaskie","augustowski","Bargłów Kościelny, gm.","200103",4590,1738,1738,1723,1359,364
"podlaskie","augustowski","Lipsk, gm.","200104",4628,1647,1647,1634,1093,541
"podlaskie","augustowski","Nowinka, gm.","200105",2204,1194,1194,1183,906,277
"podlaskie","augustowski","Płaska, gm.","200106",2092,839,839,832,531,301
"podlaskie","augustowski","Sztabin, gm.","200107",4379,1747,1746,1727,1253,474
"podlaskie","białostocki","Choroszcz, gm.","200201",10828,5263,5261,5223,3590,1633
"podlaskie","białostocki","Czarna Białostocka, gm.","200202",9098,4124,4124,4090,2510,1580
"podlaskie","białostocki","Dobrzyniewo Duże, gm.","200203",6130,2904,2904,2890,1993,897
"podlaskie","białostocki","Gródek, gm.","200204",4859,1454,1454,1435,348,1087
"podlaskie","białostocki","Juchnowiec Kościelny, gm.","200205",9684,5251,5251,5229,3482,1747
"podlaskie","białostocki","Łapy, gm.","200206",18418,10271,10269,10198,7992,2206
"podlaskie","białostocki","Michałowo, gm.","200207",6224,2083,2083,2050,922,1128
"podlaskie","białostocki","Poświętne, gm.","200208",2973,1612,1612,1598,1455,143
"podlaskie","białostocki","Supraśl, gm.","200209",9485,4659,4659,4623,2311,2312
"podlaskie","białostocki","Suraż, gm.","200210",1611,936,936,927,770,157
"podlaskie","białostocki","Turośń Kościelna, gm.","200211",3997,2211,2211,2199,1713,486
"podlaskie","białostocki","Tykocin, gm.","200212",5157,2574,2574,2563,2186,377
"podlaskie","białostocki","Wasilków, gm.","200213",9521,4773,4772,4749,2746,2003
"podlaskie","białostocki","Zabłudów, gm.","200214",9131,3950,3949,3913,2429,1484
"podlaskie","białostocki","Zawady, gm.","200215",2402,1186,1186,1183,1071,112
"podlaskie","bielski","Bielsk Podlaski, gm.","200303",6454,1817,1817,1804,915,889
"podlaskie","bielski","Bielsk Podlaski, m.","200301",21516,8585,8585,8473,3609,4864
"podlaskie","bielski","Boćki, gm.","200304",4129,1766,1766,1758,1311,447
"podlaskie","bielski","Brańsk, gm.","200305",5219,3269,3269,3236,3053,183
"podlaskie","bielski","Brańsk, m.","200302",2986,1711,1711,1695,1411,284
"podlaskie","bielski","Orla, gm.","200306",3044,864,864,849,159,690
"podlaskie","bielski","Rudka, gm.","200307",1670,870,870,865,733,132
"podlaskie","bielski","Wyszki, gm.","200308",4026,2231,2229,2215,1990,225
"podlaskie","grajewski","Grajewo, gm.","200402",4563,1601,1601,1584,1282,302
"podlaskie","grajewski","Grajewo, m.","200401",17584,7546,7546,7482,4641,2841
"podlaskie","grajewski","Radziłów, gm.","200403",4236,1873,1873,1856,1630,226
"podlaskie","grajewski","Rajgród, gm.","200404",4360,1535,1535,1519,1046,473
"podlaskie","grajewski","Szczuczyn, gm.","200405",5076,2116,2114,2096,1580,516
"podlaskie","grajewski","Wąsosz, gm.","200406",3163,1318,1318,1309,1095,214
"podlaskie","hajnowski","Białowieża, gm.","200502",2081,737,737,726,229,497
"podlaskie","hajnowski","Czeremcha, gm.","200503",3111,980,979,958,269,689
"podlaskie","hajnowski","Czyże, gm.","200504",2334,586,586,577,108,469
"podlaskie","hajnowski","Dubicze Cerkiewne, gm.","200505",1759,448,448,432,81,351
"podlaskie","hajnowski","Hajnówka, gm.","200506",3598,1026,1026,1015,256,759
"podlaskie","hajnowski","Hajnówka, m.","200501",19361,6740,6731,6643,2024,4619
"podlaskie","hajnowski","Kleszczele, gm.","200507",2586,879,879,870,247,623
"podlaskie","hajnowski","Narew, gm.","200508",3625,952,952,943,312,631
"podlaskie","hajnowski","Narewka, gm.","200509",3599,997,997,973,211,762
"podlaskie","kolneński","Grabowo, gm.","200602",2899,1271,1271,1261,1043,218
"podlaskie","kolneński","Kolno, gm.","200603",6740,3090,3090,3076,2669,407
"podlaskie","kolneński","Kolno, m.","200601",8626,3755,3755,3730,2561,1169
"podlaskie","kolneński","Mały Płock, gm.","200604",3939,1578,1578,1574,1338,236
"podlaskie","kolneński","Stawiski, gm.","200605",5218,2145,2145,2129,1772,357
"podlaskie","kolneński","Turośl, gm.","200606",3844,1600,1600,1589,1252,337
"podlaskie","łomżyński","Jedwabne, gm.","200701",4529,2305,2305,2288,2077,211
"podlaskie","łomżyński","Łomża, gm.","200702",7471,3594,3594,3579,2956,623
"podlaskie","łomżyński","Miastkowo, gm.","200703",3230,1472,1472,1458,1256,202
"podlaskie","łomżyński","Nowogród, gm.","200704",3101,1471,1471,1459,1151,308
"podlaskie","łomżyński","Piątnica, gm.","200705",7936,3299,3299,3265,2689,576
"podlaskie","łomżyński","Przytuły, gm.","200706",1796,884,884,880,815,65
"podlaskie","łomżyński","Śniadowo, gm.","200707",4474,2301,2300,2289,2018,271
"podlaskie","łomżyński","Wizna, gm.","200708",3478,1573,1572,1564,1408,156
"podlaskie","łomżyński","Zbójna, gm.","200709",3434,1472,1472,1459,1184,275
"podlaskie","moniecki","Goniądz, gm.","200801",4070,1705,1705,1693,1251,442
"podlaskie","moniecki","Jasionówka, gm.","200802",2467,1016,1016,1014,830,184
"podlaskie","moniecki","Jaświły, gm.","200803",4501,1767,1767,1756,1426,330
"podlaskie","moniecki","Knyszyn, gm.","200804",3956,1694,1694,1676,1288,388
"podlaskie","moniecki","Krypno, gm.","200805",3222,1340,1338,1325,1087,238
"podlaskie","moniecki","Mońki, gm.","200806",12445,5007,5007,4958,3494,1464
"podlaskie","moniecki","Trzcianne, gm.","200807",3804,1339,1339,1333,1075,258
"podlaskie","sejneński","Giby, gm.","200902",2387,1016,1016,1000,677,323
"podlaskie","sejneński","Krasnopol, gm.","200903",3168,1182,1182,1171,857,314
"podlaskie","sejneński","Puńsk, gm.","200904",3550,1070,1070,1054,470,584
"podlaskie","sejneński","Sejny, gm.","200905",3313,986,986,979,708,271
"podlaskie","sejneński","Sejny, m.","200901",4767,1850,1849,1833,985,848
"podlaskie","siemiatycki","Drohiczyn, gm.","201002",5648,2441,2440,2434,2006,428
"podlaskie","siemiatycki","Dziadkowice, gm.","201003",2469,1148,1148,1135,975,160
"podlaskie","siemiatycki","Grodzisk, gm.","201004",3849,1728,1728,1712,1395,317
"podlaskie","siemiatycki","Mielnik, gm.","201005",2342,941,941,926,457,469
"podlaskie","siemiatycki","Milejczyce, gm.","201006",1932,692,692,683,275,408
"podlaskie","siemiatycki","Nurzec-Stacja, gm.","201007",3902,1090,1090,1084,459,625
"podlaskie","siemiatycki","Perlejewo, gm.","201008",2535,1152,1152,1145,1049,96
"podlaskie","siemiatycki","Siemiatycze, gm.","201009",5294,1592,1592,1575,1025,550
"podlaskie","siemiatycki","Siemiatycze, m.","201001",12067,5097,5097,5042,2904,2138
"podlaskie","sokólski","Dąbrowa Białostocka, gm.","201101",10315,4451,4451,4406,3240,1166
"podlaskie","sokólski","Janów, gm.","201102",3643,1297,1297,1291,994,297
"podlaskie","sokólski","Korycin, gm.","201103",2747,1136,1136,1129,936,193
"podlaskie","sokólski","Krynki, gm.","201104",2929,1296,1296,1278,783,495
"podlaskie","sokólski","Kuźnica, gm.","201105",3548,1614,1614,1603,1261,342
"podlaskie","sokólski","Nowy Dwór, gm.","201106",2518,1057,1057,1051,698,353
"podlaskie","sokólski","Sidra, gm.","201107",3212,1144,1144,1136,865,271
"podlaskie","sokólski","Sokółka, gm.","201108",21244,8919,8914,8847,5415,3432
"podlaskie","sokólski","Suchowola, gm.","201109",6048,2300,2300,2283,1798,485
"podlaskie","sokólski","Szudziałowo, gm.","201110",2942,913,913,905,584,321
"podlaskie","suwalski","Bakałarzewo, gm.","201201",2388,972,972,964,731,233
"podlaskie","suwalski","Filipów, gm.","201202",3479,1336,1336,1329,1023,306
"podlaskie","suwalski","Jeleniewo, gm.","201203",2244,1065,1061,1054,905,149
"podlaskie","suwalski","Przerośl, gm.","201204",2328,1048,1048,1042,833,209
"podlaskie","suwalski","Raczki, gm.","201205",4629,2134,2133,2126,1640,486
"podlaskie","suwalski","Rutka-Tartak, gm.","201206",1792,734,734,726,594,132
"podlaskie","suwalski","Suwałki, gm.","201207",4991,2040,2020,2001,1365,636
"podlaskie","suwalski","Szypliszki, gm.","201208",3081,1178,1178,1166,818,348
"podlaskie","suwalski","Wiżajny, gm.","201209",2218,1014,1014,1003,739,264
"podlaskie","wysokomazowiecki","Ciechanowiec, gm.","201302",7702,3498,3498,3470,2770,700
"podlaskie","wysokomazowiecki","Czyżew-Osada, gm.","201303",5191,2626,2625,2602,2247,355
"podlaskie","wysokomazowiecki","Klukowo, gm.","201304",3817,2206,2206,2202,2091,111
"podlaskie","wysokomazowiecki","Kobylin-Borzymy, gm.","201305",2888,1738,1738,1727,1636,91
"podlaskie","wysokomazowiecki","Kulesze Kościelne, gm.","201306",2631,1593,1593,1577,1468,109
"podlaskie","wysokomazowiecki","Nowe Piekuty, gm.","201307",3260,1933,1933,1918,1793,125
"podlaskie","wysokomazowiecki","Sokoły, gm.","201308",4771,2774,2774,2755,2457,298
"podlaskie","wysokomazowiecki","Szepietowo, gm.","201309",5943,3272,3272,3250,2767,483
"podlaskie","wysokomazowiecki","Wysokie Mazowieckie, gm.","201310",4158,2218,2218,2209,1986,223
"podlaskie","wysokomazowiecki","Wysokie Mazowieckie, m.","201301",7529,3923,3922,3900,2639,1261
"podlaskie","zambrowski","Kołaki Kościelne, gm.","201402",1946,1116,1116,1113,1053,60
"podlaskie","zambrowski","Rutki, gm.","201403",5005,2554,2554,2542,1958,584
"podlaskie","zambrowski","Szumowo, gm.","201404",3965,1974,1974,1971,1717,254
"podlaskie","zambrowski","Zambrów, gm.","201405",7089,3457,3457,3440,2792,648
"podlaskie","zambrowski","Zambrów, m.","201401",18103,8003,8003,7923,5375,2548
"podlaskie","Białystok","Białystok, m.","206101",224414,123495,123446,122295,61256,61039
"podlaskie","Łomża","Łomża, m.","206201",48718,24724,24719,24537,15748,8789
"podlaskie","Suwałki","Suwałki, m.","206301",52314,25351,25343,25137,14588,10549
"pomorskie","bytowski","Borzytuchom, gm.","220101",2043,961,961,936,404,532
"pomorskie","bytowski","Bytów, gm.","220102",18088,9419,9419,9341,4380,4961
"pomorskie","bytowski","Czarna Dąbrówka, gm.","220103",4319,1934,1934,1920,1001,919
"pomorskie","bytowski","Kołczygłowy, gm.","220104",3166,1326,1326,1309,582,727
"pomorskie","bytowski","Lipnica, gm.","220105",3748,2009,2009,1992,1209,783
"pomorskie","bytowski","Miastko, gm.","220106",15566,6119,6119,6058,2506,3552
"pomorskie","bytowski","Parchowo, gm.","220107",2526,1433,1431,1418,804,614
"pomorskie","bytowski","Studzienice, gm.","220108",2543,1192,1192,1184,561,623
"pomorskie","bytowski","Trzebielino, gm.","220109",2834,1053,1050,1040,439,601
"pomorskie","bytowski","Tuchomie, gm.","220110",2820,1256,1256,1241,595,646
"pomorskie","chojnicki","Brusy, gm.","220202",9748,5764,5762,5707,3725,1982
"pomorskie","chojnicki","Chojnice, gm.","220203",11600,5318,5318,5262,2753,2509
"pomorskie","chojnicki","Chojnice, m.","220201",31660,17002,16999,16831,7263,9568
"pomorskie","chojnicki","Czersk, gm.","220204",15607,7739,7739,7679,4697,2982
"pomorskie","chojnicki","Konarzyny, gm.","220205",1602,778,778,766,404,362
"pomorskie","człuchowski","Czarne, gm.","220302",8553,3696,3696,3658,1381,2277
"pomorskie","człuchowski","Człuchów, gm.","220303",7310,2728,2728,2699,1439,1260
"pomorskie","człuchowski","Człuchów, m.","220301",12034,5763,5763,5715,2167,3548
"pomorskie","człuchowski","Debrzno, gm.","220304",7065,2608,2608,2571,1131,1440
"pomorskie","człuchowski","Koczała, gm.","220305",2850,1180,1180,1163,356,807
"pomorskie","człuchowski","Przechlewo, gm.","220306",4693,2193,2193,2170,805,1365
"pomorskie","człuchowski","Rzeczenica, gm.","220307",2894,1122,1122,1102,464,638
"pomorskie","gdański","Cedry Wielkie, gm.","220402",4557,1903,1903,1889,1026,863
"pomorskie","gdański","Kolbudy, gm.","220403",8561,4807,4807,4774,1671,3103
"pomorskie","gdański","Pruszcz Gdański, gm.","220404",12232,6749,6743,6700,2790,3910
"pomorskie","gdański","Pruszcz Gdański, m.","220401",18520,10850,10850,10753,4345,6408
"pomorskie","gdański","Przywidz, gm.","220405",3851,1899,1898,1878,804,1074
"pomorskie","gdański","Pszczółki, gm.","220406",5622,2707,2707,2685,1272,1413
"pomorskie","gdański","Suchy Dąb, gm.","220407",2852,1101,1101,1086,502,584
"pomorskie","gdański","Trąbki Wielkie, gm.","220408",6906,2978,2978,2959,1504,1455
"pomorskie","kartuski","Chmielno, gm.","220501",4626,2801,2801,2782,1562,1220
"pomorskie","kartuski","Kartuzy, gm.","220502",22982,14020,14019,13895,6754,7141
"pomorskie","kartuski","Przodkowo, gm.","220503",4811,2758,2758,2731,1664,1067
"pomorskie","kartuski","Sierakowice, gm.","220504",11410,7202,7199,7144,4992,2152
"pomorskie","kartuski","Somonino, gm.","220505",6346,3430,3430,3413,1875,1538
"pomorskie","kartuski","Stężyca, gm.","220506",6125,3668,3667,3622,2126,1496
"pomorskie","kartuski","Sulęczyno, gm.","220507",3469,2231,2231,2211,1251,960
"pomorskie","kartuski","Żukowo, gm.","220508",16853,10407,10405,10328,4777,5551
"pomorskie","kościerski","Dziemiany, gm.","220602",2956,1820,1820,1807,1193,614
"pomorskie","kościerski","Karsin, gm.","220603",4376,2506,2506,2484,1450,1034
"pomorskie","kościerski","Kościerzyna, gm.","220604",9760,5484,5484,5435,2995,2440
"pomorskie","kościerski","Kościerzyna, m.","220601",18286,10448,10445,10372,4648,5724
"pomorskie","kościerski","Liniewo, gm.","220605",3524,1910,1910,1899,1112,787
"pomorskie","kościerski","Lipusz, gm.","220606",2430,1556,1556,1540,854,686
"pomorskie","kościerski","Nowa Karczma, gm.","220607",4512,2332,2331,2314,1319,995
"pomorskie","kościerski","Stara Kiszewa, gm.","220608",4791,2295,2294,2273,1433,840
"pomorskie","kwidzyński","Gardeja, gm.","220702",6191,2010,2010,1988,1084,904
"pomorskie","kwidzyński","Kwidzyn, gm.","220703",7632,2842,2839,2800,1385,1415
"pomorskie","kwidzyński","Kwidzyn, m.","220701",29957,15064,15064,14919,6044,8875
"pomorskie","kwidzyński","Prabuty, gm.","220704",10301,3950,3950,3912,2049,1863
"pomorskie","kwidzyński","Ryjewo, gm.","220705",4213,1590,1589,1554,724,830
"pomorskie","kwidzyński","Sadlinki, gm.","220706",4068,1437,1437,1426,831,595
"pomorskie","lęborski","Cewice, gm.","220803",5090,2436,2436,2422,1213,1209
"pomorskie","lęborski","Lębork, m.","220801",27609,14425,14421,14283,6279,8004
"pomorskie","lęborski","Łeba, m.","220802",3175,1613,1613,1592,598,994
"pomorskie","lęborski","Nowa Wieś Lęborska, gm.","220804",8973,4253,4253,4204,2157,2047
"pomorskie","lęborski","Wicko, gm.","220805",4115,1481,1480,1463,685,778
"pomorskie","malborski","Lichnowy, gm.","220903",3451,1321,1321,1308,755,553
"pomorskie","malborski","Malbork, gm.","220904",3064,1095,1095,1082,585,497
"pomorskie","malborski","Malbork, m.","220901",31141,15862,15858,15701,6249,9452
"pomorskie","malborski","Miłoradz, gm.","220906",2653,1044,1043,1033,605,428
"pomorskie","malborski","Nowy Staw, gm.","220907",6184,2514,2514,2490,1289,1201
"pomorskie","malborski","Stare Pole, gm.","220908",3535,1481,1481,1471,763,708
"pomorskie","nowodworski","Krynica Morska, m.","221001",1094,525,525,522,190,332
"pomorskie","nowodworski","Nowy Dwór Gdański, gm.","221002",13993,5882,5878,5817,2641,3176
"pomorskie","nowodworski","Ostaszewo, gm.","221003",2447,1028,1028,1018,527,491
"pomorskie","nowodworski","Stegna, gm.","221004",7669,3340,3340,3308,1604,1704
"pomorskie","nowodworski","Sztutowo, gm.","221005",2860,1284,1283,1265,587,678
"pomorskie","pucki","Hel, m.","221101",3320,1677,1677,1656,545,1111
"pomorskie","pucki","Jastarnia, m.","221102",3183,1958,1958,1944,879,1065
"pomorskie","pucki","Kosakowo, gm.","221105",5900,3599,3597,3574,1400,2174
"pomorskie","pucki","Krokowa, gm.","221106",7337,3913,3913,3865,1588,2277
"pomorskie","pucki","Puck, gm.","221107",15425,8370,8363,8290,3468,4822
"pomorskie","pucki","Puck, m.","221103",9173,5142,5140,5075,1501,3574
"pomorskie","pucki","Władysławowo, m.","221104",11454,6815,6814,6742,2187,4555
"pomorskie","słupski","Damnica, gm.","221202",4552,1509,1509,1494,722,772
"pomorskie","słupski","Dębnica Kaszubska, gm.","221203",7117,2637,2636,2602,1101,1501
"pomorskie","słupski","Główczyce, gm.","221204",7207,2642,2642,2598,1222,1376
"pomorskie","słupski","Kępice, gm.","221205",7386,2833,2833,2807,1044,1763
"pomorskie","słupski","Kobylnica, gm.","221206",7445,2870,2870,2851,1286,1565
"pomorskie","słupski","Potęgowo, gm.","221207",5320,1825,1825,1799,861,938
"pomorskie","słupski","Słupsk, gm.","221208",10310,3810,3810,3767,1605,2162
"pomorskie","słupski","Smołdzino, gm.","221209",2697,1077,1077,1060,527,533
"pomorskie","słupski","Ustka, gm.","221210",5569,2204,2204,2187,995,1192
"pomorskie","słupski","Ustka, m.","221201",14926,7062,7061,6982,2641,4341
"pomorskie","starogardzki","Bobowo, gm.","221304",2097,1065,1065,1054,744,310
"pomorskie","starogardzki","Czarna Woda, m.","221301",2641,1502,1502,1484,854,630
"pomorskie","starogardzki","Kaliska, gm.","221305",3787,1919,1919,1904,930,974
"pomorskie","starogardzki","Lubichowo, gm.","221306",4317,2110,2110,2084,1198,886
"pomorskie","starogardzki","Osieczna, gm.","221307",2119,1175,1175,1164,662,502
"pomorskie","starogardzki","Osiek, gm.","221308",2021,928,928,918,473,445
"pomorskie","starogardzki","Skarszewy, gm.","221309",10054,4844,4844,4808,2574,2234
"pomorskie","starogardzki","Skórcz, gm.","221310",3416,1565,1565,1549,984,565
"pomorskie","starogardzki","Skórcz, m.","221302",2552,1336,1336,1323,713,610
"pomorskie","starogardzki","Smętowo Graniczne, gm.","221311",4044,1769,1769,1749,910,839
"pomorskie","starogardzki","Starogard Gdański, gm.","221312",9296,4808,4807,4733,2749,1984
"pomorskie","starogardzki","Starogard Gdański, m.","221303",38446,20629,20627,20455,10331,10124
"pomorskie","starogardzki","Zblewo, gm.","221313",7738,3838,3837,3800,2256,1544
"pomorskie","tczewski","Gniew, gm.","221402",12190,5225,5224,5181,2503,2678
"pomorskie","tczewski","Morzeszczyn, gm.","221403",2759,1123,1123,1114,631,483
"pomorskie","tczewski","Pelplin, gm.","221404",12561,5650,5650,5609,2937,2672
"pomorskie","tczewski","Subkowy, gm.","221405",3702,1614,1614,1597,910,687
"pomorskie","tczewski","Tczew, gm.","221406",8197,3867,3867,3832,1979,1853
"pomorskie","tczewski","Tczew, m.","221401",46948,26004,26002,25786,11404,14382
"pomorskie","wejherowski","Choczewo, gm.","221504",4423,1920,1920,1900,638,1262
"pomorskie","wejherowski","Gniewino, gm.","221505",4787,2165,2165,2142,854,1288
"pomorskie","wejherowski","Linia, gm.","221506",3970,2279,2277,2244,1410,834
"pomorskie","wejherowski","Luzino, gm.","221507",8484,4927,4927,4885,2832,2053
"pomorskie","wejherowski","Łęczyce, gm.","221508",8042,4079,4079,4048,2004,2044
"pomorskie","wejherowski","Reda, m.","221501",13437,8292,8289,8216,3090,5126
"pomorskie","wejherowski","Rumia, m.","221502",34181,21263,21255,21093,8579,12514
"pomorskie","wejherowski","Szemud, gm.","221509",8637,5030,5030,5002,2668,2334
"pomorskie","wejherowski","Wejherowo, gm.","221510",12292,6862,6862,6818,3319,3499
"pomorskie","wejherowski","Wejherowo, m.","221503",35926,21387,21384,21196,8967,12229
"pomorskie","sztumski","Dzierzgoń, gm.","221601",7346,3161,3159,3118,1516,1602
"pomorskie","sztumski","Mikołajki Pomorskie, gm.","221602",2803,858,858,847,463,384
"pomorskie","sztumski","Stary Dzierzgoń, gm.","221603",3238,902,901,885,463,422
"pomorskie","sztumski","Stary Targ, gm.","221604",4971,1754,1754,1738,861,877
"pomorskie","sztumski","Sztum, gm.","221605",15572,7166,7164,7083,2880,4203
"pomorskie","Gdańsk","Gdańsk, m.","226101",367181,233665,233541,231302,87621,143681
"pomorskie","Gdynia","Gdynia, m.","226201",200504,126589,126546,125279,45578,79701
"pomorskie","Słupsk","Słupsk, m.","226301",77847,40400,40394,39972,16833,23139
"pomorskie","Sopot","Sopot, m.","226401",33824,22587,22580,22379,7862,14517
"pomorskie","Statki","Statki","229901",114,114,114,109,32,77
"śląskie","będziński","Będzin, m.","240101",49170,23179,23176,22921,10136,12785
"śląskie","będziński","Bobrowniki, gm.","240104",9403,4502,4502,4454,2191,2263
"śląskie","będziński","Czeladź, m.","240102",28853,14069,14064,13835,6389,7446
"śląskie","będziński","Mierzęcice, gm.","240105",5778,2339,2339,2306,1267,1039
"śląskie","będziński","Psary, gm.","240106",9174,3993,3993,3941,1837,2104
"śląskie","będziński","Siewierz, gm.","240107",9828,4351,4348,4298,2492,1806
"śląskie","będziński","Sławków, m.","240108",5638,2722,2722,2687,1438,1249
"śląskie","będziński","Wojkowice, m.","240103",8694,3954,3953,3897,1449,2448
"śląskie","bielski","Bestwina, gm.","240202",7926,4641,4640,4600,2641,1959
"śląskie","bielski","Buczkowice, gm.","240203",8165,4807,4807,4750,2744,2006
"śląskie","bielski","Czechowice-Dziedzice, gm.","240204",33776,19372,19361,19203,9669,9534
"śląskie","bielski","Jasienica, gm.","240205",15526,8948,8944,8878,4891,3987
"śląskie","bielski","Jaworze, gm.","240206",4957,2828,2828,2798,1012,1786
"śląskie","bielski","Kozy, gm.","240207",8887,5410,5402,5361,3026,2335
"śląskie","bielski","Porąbka, gm.","240208",11408,6783,6780,6724,4427,2297
"śląskie","bielski","Szczyrk, m.","240201",4650,2766,2765,2747,1611,1136
"śląskie","bielski","Wilamowice, gm.","240209",11259,6597,6593,6535,4310,2225
"śląskie","bielski","Wilkowice, gm.","240210",10313,5811,5809,5746,2841,2905
"śląskie","cieszyński","Brenna, gm.","240304",7756,4032,4031,4005,2302,1703
"śląskie","cieszyński","Chybie, gm.","240305",6918,3782,3782,3753,2178,1575
"śląskie","cieszyński","Cieszyn, m.","240301",29122,15798,15791,15616,5593,10023
"śląskie","cieszyński","Dębowiec, gm.","240306",4126,2004,2004,1977,892,1085
"śląskie","cieszyński","Goleszów, gm.","240307",9652,4695,4694,4622,1353,3269
"śląskie","cieszyński","Hażlach, gm.","240308",7299,3528,3528,3481,1781,1700
"śląskie","cieszyński","Istebna, gm.","240309",8342,5056,5056,5016,2926,2090
"śląskie","cieszyński","Skoczów, gm.","240310",19999,10429,10428,10312,4765,5547
"śląskie","cieszyński","Strumień, gm.","240311",9097,4842,4841,4790,2748,2042
"śląskie","cieszyński","Ustroń, m.","240302",14275,7844,7844,7768,2737,5031
"śląskie","cieszyński","Wisła, m.","240303",9357,4739,4739,4690,777,3913
"śląskie","cieszyński","Zebrzydowice, gm.","240312",9543,5087,5085,5024,2886,2138
"śląskie","częstochowski","Blachownia, gm.","240401",10855,4997,4997,4930,2453,2477
"śląskie","częstochowski","Dąbrowa Zielona, gm.","240402",3415,1191,1191,1177,824,353
"śląskie","częstochowski","Janów, gm.","240403",4652,2158,2158,2131,1380,751
"śląskie","częstochowski","Kamienica Polska, gm.","240404",4441,1839,1839,1821,840,981
"śląskie","częstochowski","Kłomnice, gm.","240405",10959,4532,4531,4471,2851,1620
"śląskie","częstochowski","Koniecpol, gm.","240406",8539,3303,3303,3247,2122,1125
"śląskie","częstochowski","Konopiska, gm.","240407",8250,3643,3643,3603,1884,1719
"śląskie","częstochowski","Kruszyna, gm.","240408",3769,1546,1543,1520,1097,423
"śląskie","częstochowski","Lelów, gm.","240409",4194,1684,1684,1653,1174,479
"śląskie","częstochowski","Mstów, gm.","240410",7740,3473,3472,3437,2403,1034
"śląskie","częstochowski","Mykanów, gm.","240411",10715,5187,5186,5131,3555,1576
"śląskie","częstochowski","Olsztyn, gm.","240412",5705,2587,2587,2565,1396,1169
"śląskie","częstochowski","Poczesna, gm.","240413",9880,4823,4822,4767,2634,2133
"śląskie","częstochowski","Przyrów, gm.","240414",3278,1255,1255,1222,753,469
"śląskie","częstochowski","Rędziny, gm.","240415",7671,3703,3703,3650,2235,1415
"śląskie","częstochowski","Starcza, gm.","240416",2194,907,907,900,538,362
"śląskie","gliwicki","Gierałtowice, gm.","240503",8549,4941,4941,4894,2785,2109
"śląskie","gliwicki","Knurów, m.","240501",31926,16871,16870,16715,9386,7329
"śląskie","gliwicki","Pilchowice, gm.","240504",8346,3871,3869,3842,1824,2018
"śląskie","gliwicki","Pyskowice, m.","240502",15203,6625,6625,6549,2811,3738
"śląskie","gliwicki","Rudziniec, gm.","240505",8493,3377,3377,3333,1431,1902
"śląskie","gliwicki","Sośnicowice, gm.","240506",6509,2787,2786,2774,980,1794
"śląskie","gliwicki","Toszek, gm.","240507",8796,2973,2972,2947,1259,1688
"śląskie","gliwicki","Wielowieś, gm.","240508",4690,1631,1631,1610,811,799
"śląskie","kłobucki","Kłobuck, gm.","240601",16448,8047,8046,7940,4493,3447
"śląskie","kłobucki","Krzepice, gm.","240602",7558,3468,3468,3426,2203,1223
"śląskie","kłobucki","Lipie, gm.","240603",5159,2093,2089,2061,1411,650
"śląskie","kłobucki","Miedźno, gm.","240604",5867,2849,2849,2817,2195,622
"śląskie","kłobucki","Opatów, gm.","240605",5314,2095,2095,2056,1453,603
"śląskie","kłobucki","Panki, gm.","240606",3916,1548,1548,1505,953,552
"śląskie","kłobucki","Popów, gm.","240607",4903,1865,1865,1838,1254,584
"śląskie","kłobucki","Przystajń, gm.","240608",4716,1844,1844,1828,1132,696
"śląskie","kłobucki","Wręczyca Wielka, gm.","240609",13366,5744,5742,5640,3448,2192
"śląskie","lubliniecki","Boronów, gm.","240702",2580,1326,1326,1320,814,506
"śląskie","lubliniecki","Ciasna, gm.","240703",6204,2098,2098,2074,910,1164
"śląskie","lubliniecki","Herby, gm.","240704",6000,2973,2972,2929,1232,1697
"śląskie","lubliniecki","Kochanowice, gm.","240705",5205,2211,2211,2193,1280,913
"śląskie","lubliniecki","Koszęcin, gm.","240706",9078,4704,4701,4669,2734,1935
"śląskie","lubliniecki","Lubliniec, m.","240701",19119,9893,9891,9762,4278,5484
"śląskie","lubliniecki","Pawonków, gm.","240707",5029,2014,2014,1996,924,1072
"śląskie","lubliniecki","Woźniki, gm.","240708",7520,3993,3991,3952,2300,1652
"śląskie","mikołowski","Łaziska Górne, m.","240801",17190,9223,9221,9154,4951,4203
"śląskie","mikołowski","Mikołów, m.","240802",30873,17742,17731,17586,7750,9836
"śląskie","mikołowski","Ornontowice, gm.","240804",4017,2359,2357,2343,1468,875
"śląskie","mikołowski","Orzesze, m.","240803",14617,8048,8047,7977,4706,3271
"śląskie","mikołowski","Wyry, gm.","240805",4921,2974,2974,2963,1719,1244
"śląskie","myszkowski","Koziegłowy, gm.","240902",11703,4605,4604,4565,3084,1481
"śląskie","myszkowski","Myszków, m.","240901",26680,12102,12101,11934,6097,5837
"śląskie","myszkowski","Niegowa, gm.","240903",4528,2006,2006,1984,1593,391
"śląskie","myszkowski","Poraj, gm.","240904",8707,3803,3802,3754,1874,1880
"śląskie","myszkowski","Żarki, gm.","240905",6432,2809,2808,2774,1759,1015
"śląskie","pszczyński","Goczałkowice-Zdrój, gm.","241001",4886,2898,2898,2856,1420,1436
"śląskie","pszczyński","Kobiór, gm.","241002",3643,2131,2131,2115,1263,852
"śląskie","pszczyński","Miedźna, gm.","241003",11443,6568,6566,6528,4584,1944
"śląskie","pszczyński","Pawłowice, gm.","241004",13356,7434,7431,7373,5279,2094
"śląskie","pszczyński","Pszczyna, gm.","241005",39417,22543,22528,22382,11470,10912
"śląskie","pszczyński","Suszec, gm.","241006",7828,4596,4595,4548,3113,1435
"śląskie","raciborski","Kornowac, gm.","241102",3663,1775,1775,1768,1041,727
"śląskie","raciborski","Krzanowice, gm.","241103",4865,1578,1578,1561,477,1084
"śląskie","raciborski","Krzyżanowice, gm.","241104",9105,3298,3296,3262,1173,2089
"śląskie","raciborski","Kuźnia Raciborska, gm.","241105",9702,3457,3457,3419,1177,2242
"śląskie","raciborski","Nędza, gm.","241106",5892,2309,2309,2291,936,1355
"śląskie","raciborski","Pietrowice Wielkie, gm.","241107",5735,1975,1975,1947,612,1335
"śląskie","raciborski","Racibórz, m.","241101",47635,21404,21401,21207,8391,12816
"śląskie","raciborski","Rudnik, gm.","241108",4179,1393,1393,1382,592,790
"śląskie","rybnicki","Czerwionka-Leszczyny, gm.","241201",32250,16972,16969,16849,10069,6780
"śląskie","rybnicki","Gaszowice, gm.","241202",6752,3361,3361,3345,1806,1539
"śląskie","rybnicki","Jejkowice, gm.","241203",2834,1629,1629,1620,1002,618
"śląskie","rybnicki","Lyski, gm.","241204",7196,3685,3685,3656,1853,1803
"śląskie","rybnicki","Świerklany, gm.","241205",8527,4819,4815,4725,3236,1489
"śląskie","tarnogórski","Kalety, m.","241301",7042,3561,3561,3529,1886,1643
"śląskie","tarnogórski","Krupski Młyn, gm.","241305",2738,1378,1378,1361,664,697
"śląskie","tarnogórski","Miasteczko Śląskie, m.","241302",5906,2879,2879,2854,1441,1413
"śląskie","tarnogórski","Ożarowice, gm.","241306",4303,2089,2089,2066,1229,837
"śląskie","tarnogórski","Radzionków, m.","241303",13775,7647,7647,7598,3969,3629
"śląskie","tarnogórski","Świerklaniec, gm.","241307",8745,4372,4372,4342,2043,2299
"śląskie","tarnogórski","Tarnowskie Góry, m.","241304",51448,26890,26880,26636,11184,15452
"śląskie","tarnogórski","Tworóg, gm.","241308",6439,2633,2632,2607,1253,1354
"śląskie","tarnogórski","Zbrosławice, gm.","241309",12407,4559,4559,4519,1922,2597
"śląskie","bieruńsko-lędziński","Bieruń, m.","241401",15488,8411,8411,8356,5106,3250
"śląskie","bieruńsko-lędziński","Bojszowy, gm.","241404",5005,3251,3251,3222,2297,925
"śląskie","bieruńsko-lędziński","Chełm Śląski, gm.","241405",4451,2456,2456,2417,1590,827
"śląskie","bieruńsko-lędziński","Imielin, m.","241402",6151,3481,3481,3449,2063,1386
"śląskie","bieruńsko-lędziński","Lędziny, m.","241403",12218,6566,6558,6516,4443,2073
"śląskie","wodzisławski","Godów, gm.","241505",9846,5569,5569,5516,3604,1912
"śląskie","wodzisławski","Gorzyce, gm.","241506",15355,7747,7745,7687,4343,3344
"śląskie","wodzisławski","Lubomia, gm.","241507",6387,3129,3128,3102,1922,1180
"śląskie","wodzisławski","Marklowice, gm.","241508",4069,2278,2274,2262,1427,835
"śląskie","wodzisławski","Mszana, gm.","241509",5380,3073,3071,3050,2273,777
"śląskie","wodzisławski","Pszów, m.","241501",11311,5680,5677,5639,3408,2231
"śląskie","wodzisławski","Radlin, m.","241502",14065,7041,7036,6977,3731,3246
"śląskie","wodzisławski","Rydułtowy, m.","241503",17693,8760,8750,8697,4527,4170
"śląskie","wodzisławski","Wodzisław Śląski, m.","241504",39527,21145,21141,20996,11020,9976
"śląskie","zawierciański","Irządze, gm.","241603",2327,827,827,813,638,175
"śląskie","zawierciański","Kroczyce, gm.","241604",4842,1917,1917,1898,1241,657
"śląskie","zawierciański","Łazy, gm.","241605",13333,5923,5922,5844,3031,2813
"śląskie","zawierciański","Ogrodzieniec, gm.","241606",7903,3608,3605,3568,2079,1489
"śląskie","zawierciański","Pilica, gm.","241607",7566,3499,3499,3459,2637,822
"śląskie","zawierciański","Poręba, m.","241601",7360,3273,3272,3230,1543,1687
"śląskie","zawierciański","Szczekociny, gm.","241608",6947,3273,3273,3235,2228,1007
"śląskie","zawierciański","Włodowice, gm.","241609",4236,1674,1674,1655,999,656
"śląskie","zawierciański","Zawiercie, m.","241602",44789,20790,20787,20554,9976,10578
"śląskie","zawierciański","Żarnowiec, gm.","241610",3967,2059,2057,2033,1738,295
"śląskie","żywiecki","Czernichów, gm.","241702",4968,3280,3279,3255,2078,1177
"śląskie","żywiecki","Gilowice, gm.","241703",4372,2508,2507,2480,1680,800
"śląskie","żywiecki","Jeleśnia, gm.","241704",10501,5662,5662,5614,3647,1967
"śląskie","żywiecki","Koszarawa, gm.","241705",1965,970,968,960,638,322
"śląskie","żywiecki","Lipowa, gm.","241706",7387,4054,4053,4029,2257,1772
"śląskie","żywiecki","Łękawica, gm.","241707",3254,1808,1807,1791,1247,544
"śląskie","żywiecki","Łodygowice, gm.","241708",10271,5973,5970,5897,3698,2199
"śląskie","żywiecki","Milówka, gm.","241709",7613,3902,3900,3873,2770,1103
"śląskie","żywiecki","Radziechowy-Wieprz, gm.","241710",9451,5347,5347,5315,3707,1608
"śląskie","żywiecki","Rajcza, gm.","241711",7475,3522,3522,3505,2099,1406
"śląskie","żywiecki","Ślemień, gm.","241712",2639,1458,1458,1447,1080,367
"śląskie","żywiecki","Świnna, gm.","241713",6058,3334,3333,3307,2117,1190
"śląskie","żywiecki","Ujsoły, gm.","241714",3730,1778,1777,1769,1060,709
"śląskie","żywiecki","Węgierska Górka, gm.","241715",11422,6531,6529,6462,4015,2447
"śląskie","żywiecki","Żywiec, m.","241701",25798,14257,14257,14105,7066,7039
"śląskie","Bielsko-Biała","Bielsko-Biała, m.","246101",141476,84854,84826,84089,39503,44586
"śląskie","Bytom","Bytom, m.","246201",153045,67735,67727,67044,29621,37423
"śląskie","Chorzów","Chorzów, m.","246301",92641,45566,45553,45070,16720,28350
"śląskie","Częstochowa","Częstochowa, m.","246401",199732,107728,107672,106526,50267,56259
"śląskie","Dąbrowa Górnicza","Dąbrowa Górnicza, m.","246501",106319,50891,50884,50217,23064,27153
"śląskie","Gliwice","Gliwice, m.","246601",159497,83620,83605,82795,32305,50490
"śląskie","Jastrzębie-Zdrój","Jastrzębie-Zdrój, m.","246701",75896,40498,40494,40126,25255,14871
"śląskie","Jaworzno","Jaworzno, m.","246801",76680,38712,38705,38349,18873,19476
"śląskie","Katowice","Katowice, m.","246901",261467,148044,147965,146584,60349,86235
"śląskie","Mysłowice","Mysłowice, m.","247001",60714,32460,32455,32158,16821,15337
"śląskie","Piekary Śląskie","Piekary Śląskie, m.","247101",48549,24787,24782,24527,13109,11418
"śląskie","Ruda Śląska","Ruda Śląska, m.","247201",116818,59703,59691,59113,31332,27781
"śląskie","Rybnik","Rybnik, m.","247301",112016,59079,59071,58653,29669,28984
"śląskie","Siemianowice Śląskie","Siemianowice Śląskie, m.","247401",59394,30163,30158,29843,12052,17791
"śląskie","Sosnowiec","Sosnowiec, m.","247501",189702,93173,93145,91964,42006,49958
"śląskie","Świętochłowice","Świętochłowice, m.","247601",44617,20236,20231,20017,8379,11638
"śląskie","Tychy","Tychy, m.","247701",106461,60775,60765,60226,28196,32030
"śląskie","Zabrze","Zabrze, m.","247801",152112,64930,64920,64282,27861,36421
"śląskie","Żory","Żory, m.","247901",49802,26110,26102,25931,14052,11879
"świętokrzyskie","buski","Busko-Zdrój, gm.","260101",28027,13052,13052,12945,7907,5038
"świętokrzyskie","buski","Gnojno, gm.","260102",3798,1532,1532,1522,1252,270
"świętokrzyskie","buski","Nowy Korczyn, gm.","260103",5378,2331,2328,2307,1911,396
"świętokrzyskie","buski","Pacanów, gm.","260104",6588,2548,2548,2525,2059,466
"świętokrzyskie","buski","Solec-Zdrój, gm.","260105",4141,1852,1852,1832,1439,393
"świętokrzyskie","buski","Stopnica, gm.","260106",6542,2736,2736,2712,2166,546
"świętokrzyskie","buski","Tuczępy, gm.","260107",3054,1392,1392,1373,1158,215
"świętokrzyskie","buski","Wiślica, gm.","260108",4822,1850,1850,1828,1452,376
"świętokrzyskie","jędrzejowski","Imielno, gm.","260201",3669,1492,1492,1481,1280,201
"świętokrzyskie","jędrzejowski","Jędrzejów, gm.","260202",23878,10640,10639,10509,7095,3414
"świętokrzyskie","jędrzejowski","Małogoszcz, gm.","260203",9182,4277,4277,4237,3227,1010
"świętokrzyskie","jędrzejowski","Nagłowice, gm.","260204",4270,1555,1555,1533,1147,386
"świętokrzyskie","jędrzejowski","Oksa, gm.","260205",3865,1572,1572,1560,1165,395
"świętokrzyskie","jędrzejowski","Sędziszów, gm.","260206",10776,4543,4542,4492,3257,1235
"świętokrzyskie","jędrzejowski","Słupia (Jędrzejowska), gm.","260207",3644,1209,1209,1200,978,222
"świętokrzyskie","jędrzejowski","Sobków, gm.","260208",6447,2839,2839,2810,2231,579
"świętokrzyskie","jędrzejowski","Wodzisław, gm.","260209",6306,2541,2541,2516,1984,532
"świętokrzyskie","kazimierski","Bejsce, gm.","260301",3616,1152,1152,1144,907,237
"świętokrzyskie","kazimierski","Czarnocin, gm.","260302",3473,1274,1274,1258,1058,200
"świętokrzyskie","kazimierski","Kazimierza Wielka, gm.","260303",14034,5052,5052,4993,3502,1491
"świętokrzyskie","kazimierski","Opatowiec, gm.","260304",3183,1058,1058,1047,829,218
"świętokrzyskie","kazimierski","Skalbmierz, gm.","260305",5634,2006,2006,1991,1641,350
"świętokrzyskie","kielecki","Bieliny, gm.","260401",7315,3174,3174,3146,2606,540
"świętokrzyskie","kielecki","Bodzentyn, gm.","260402",9106,3735,3735,3674,2730,944
"świętokrzyskie","kielecki","Chęciny, gm.","260403",12100,5545,5545,5512,3632,1880
"świętokrzyskie","kielecki","Chmielnik, gm.","260404",9087,4292,4291,4226,3006,1220
"świętokrzyskie","kielecki","Daleszyce, gm.","260405",10859,4739,4739,4712,3415,1297
"świętokrzyskie","kielecki","Górno, gm.","260406",9380,4481,4478,4448,3626,822
"świętokrzyskie","kielecki","Łagów, gm.","260407",5465,2139,2139,2120,1737,383
"świętokrzyskie","kielecki","Łopuszno, gm.","260408",6847,3345,3345,3319,2673,646
"świętokrzyskie","kielecki","Masłów, gm.","260409",7216,3654,3654,3621,2467,1154
"świętokrzyskie","kielecki","Miedziana Góra, gm.","260410",7572,3770,3770,3705,2491,1214
"świętokrzyskie","kielecki","Mniów, gm.","260411",6968,3276,3275,3252,2730,522
"świętokrzyskie","kielecki","Morawica, gm.","260412",9851,4507,4507,4467,2881,1586
"świętokrzyskie","kielecki","Nowa Słupia, gm.","260413",7995,2816,2816,2792,2009,783
"świętokrzyskie","kielecki","Piekoszów, gm.","260414",11358,5150,5148,5108,3805,1303
"świętokrzyskie","kielecki","Pierzchnica, gm.","260415",3615,1538,1538,1522,1180,342
"świętokrzyskie","kielecki","Raków, gm.","260416",4788,1898,1898,1878,1418,460
"świętokrzyskie","kielecki","Sitkówka-Nowiny, gm.","260417",5292,2672,2670,2647,1666,981
"świętokrzyskie","kielecki","Strawczyn, gm.","260418",7160,3514,3511,3477,2829,648
"świętokrzyskie","kielecki","Zagnańsk, gm.","260419",9871,5142,5141,5109,3308,1801
"świętokrzyskie","konecki","Fałków, gm.","260501",4132,1525,1525,1510,1103,407
"świętokrzyskie","konecki","Gowarczów, gm.","260502",3846,1533,1532,1513,1113,400
"świętokrzyskie","konecki","Końskie, gm.","260503",30715,15236,15236,15086,8788,6298
"świętokrzyskie","konecki","Radoszyce, gm.","260504",7449,3386,3385,3348,2764,584
"świętokrzyskie","konecki","Ruda Maleniecka, gm.","260505",2835,1324,1324,1307,947,360
"świętokrzyskie","konecki","Słupia (Konecka), gm.","260506",2881,1254,1254,1242,1013,229
"świętokrzyskie","konecki","Smyków, gm.","260507",2870,1309,1309,1298,1057,241
"świętokrzyskie","konecki","Stąporków, gm.","260508",15321,6349,6349,6283,4036,2247
"świętokrzyskie","opatowski","Baćkowice, gm.","260601",4167,1734,1734,1714,1511,203
"świętokrzyskie","opatowski","Iwaniska, gm.","260602",5582,2223,2223,2202,1871,331
"świętokrzyskie","opatowski","Lipnik, gm.","260603",4671,1625,1625,1610,1307,303
"świętokrzyskie","opatowski","Opatów, gm.","260604",10463,4227,4225,4132,2802,1330
"świętokrzyskie","opatowski","Ożarów, gm.","260605",9319,3113,3113,3078,2104,974
"świętokrzyskie","opatowski","Sadowie, gm.","260606",3434,1185,1185,1170,918,252
"świętokrzyskie","opatowski","Tarłów, gm.","260607",4649,1551,1551,1527,1179,348
"świętokrzyskie","opatowski","Wojciechowice, gm.","260608",3625,1152,1152,1138,878,260
"świętokrzyskie","ostrowiecki","Bałtów, gm.","260702",3120,962,962,953,689,264
"świętokrzyskie","ostrowiecki","Bodzechów, gm.","260703",10749,4297,4296,4238,2636,1602
"świętokrzyskie","ostrowiecki","Ćmielów, gm.","260704",6476,2293,2293,2257,1373,884
"świętokrzyskie","ostrowiecki","Kunów, gm.","260705",8032,3034,3034,3002,2034,968
"świętokrzyskie","ostrowiecki","Ostrowiec Świętokrzyski, m.","260701",62580,26824,26815,26493,14653,11840
"świętokrzyskie","ostrowiecki","Waśniów, gm.","260706",5647,2092,2092,2084,1774,310
"świętokrzyskie","pińczowski","Działoszyce, gm.","260801",4793,1551,1551,1535,1167,368
"świętokrzyskie","pińczowski","Kije, gm.","260802",3661,1568,1568,1551,1234,317
"świętokrzyskie","pińczowski","Michałów, gm.","260803",3973,1440,1440,1427,1142,285
"świętokrzyskie","pińczowski","Pińczów, gm.","260804",18645,8095,8095,8001,4909,3092
"świętokrzyskie","pińczowski","Złota, gm.","260805",4056,1272,1272,1251,983,268
"świętokrzyskie","sandomierski","Dwikozy, gm.","260902",7476,2621,2621,2592,1898,694
"świętokrzyskie","sandomierski","Klimontów, gm.","260903",6896,2743,2743,2711,2104,607
"świętokrzyskie","sandomierski","Koprzywnica, gm.","260904",5579,2783,2783,2747,2220,527
"świętokrzyskie","sandomierski","Łoniów, gm.","260905",5806,2561,2559,2535,2047,488
"świętokrzyskie","sandomierski","Obrazów, gm.","260906",5438,2213,2213,2177,1811,366
"świętokrzyskie","sandomierski","Samborzec, gm.","260907",7383,3379,3379,3340,2634,706
"świętokrzyskie","sandomierski","Sandomierz, m.","260901",20885,9986,9983,9884,5648,4236
"świętokrzyskie","sandomierski","Wilczyce, gm.","260908",3151,1194,1194,1177,972,205
"świętokrzyskie","sandomierski","Zawichost, gm.","260909",3892,1585,1585,1549,1159,390
"świętokrzyskie","skarżyski","Bliżyn, gm.","261002",7010,2995,2994,2965,1799,1166
"świętokrzyskie","skarżyski","Łączna, gm.","261003",4117,1867,1867,1850,1366,484
"świętokrzyskie","skarżyski","Skarżysko Kościelne, gm.","261004",5101,2399,2399,2382,1570,812
"świętokrzyskie","skarżyski","Skarżysko-Kamienna, m.","261001",42037,20440,20436,20187,11032,9155
"świętokrzyskie","skarżyski","Suchedniów, gm.","261005",8970,4285,4285,4243,2417,1826
"świętokrzyskie","starachowicki","Brody, gm.","261102",8595,3726,3725,3695,2649,1046
"świętokrzyskie","starachowicki","Mirzec, gm.","261103",6664,3131,3131,3103,2436,667
"świętokrzyskie","starachowicki","Pawłów, gm.","261104",11516,4852,4852,4823,4042,781
"świętokrzyskie","starachowicki","Starachowice, m.","261101",44803,20602,20602,20352,10763,9589
"świętokrzyskie","starachowicki","Wąchock, gm.","261105",5821,2714,2714,2683,1665,1018
"świętokrzyskie","staszowski","Bogoria, gm.","261201",6243,2370,2370,2345,1853,492
"świętokrzyskie","staszowski","Łubnice, gm.","261202",3460,1638,1638,1628,1423,205
"świętokrzyskie","staszowski","Oleśnica, gm.","261203",3163,1298,1298,1287,1028,259
"świętokrzyskie","staszowski","Osiek, gm.","261204",6232,2887,2887,2871,2444,427
"świętokrzyskie","staszowski","Połaniec, gm.","261205",9398,4272,4272,4231,3211,1020
"świętokrzyskie","staszowski","Rytwiany, gm.","261206",5057,1992,1992,1968,1562,406
"świętokrzyskie","staszowski","Staszów, gm.","261207",21727,9277,9276,9196,5810,3386
"świętokrzyskie","staszowski","Szydłów, gm.","261208",4027,1664,1664,1637,1276,361
"świętokrzyskie","włoszczowski","Kluczewsko, gm.","261301",4053,1906,1906,1890,1602,288
"świętokrzyskie","włoszczowski","Krasocin, gm.","261302",8322,3866,3866,3828,2816,1012
"świętokrzyskie","włoszczowski","Moskorzew, gm.","261303",2431,993,993,982,772,210
"świętokrzyskie","włoszczowski","Radków, gm.","261304",2196,708,708,701,487,214
"świętokrzyskie","włoszczowski","Secemin, gm.","261305",4244,1465,1465,1449,1078,371
"świętokrzyskie","włoszczowski","Włoszczowa, gm.","261306",16471,7706,7704,7609,5192,2417
"świętokrzyskie","Kielce","Kielce, m.","266101",167336,94691,94650,93544,47020,46524
"warmińsko-mazurskie","bartoszycki","Bartoszyce, gm.","280103",8259,2901,2899,2851,1702,1149
"warmińsko-mazurskie","bartoszycki","Bartoszyce, m.","280101",21102,9815,9813,9707,4286,5421
"warmińsko-mazurskie","bartoszycki","Bisztynek, gm.","280104",5577,1685,1685,1662,728,934
"warmińsko-mazurskie","bartoszycki","Górowo Iławeckie, gm.","280105",7104,2139,2139,2108,816,1292
"warmińsko-mazurskie","bartoszycki","Górowo Iławeckie, m.","280102",3715,1531,1530,1519,680,839
"warmińsko-mazurskie","bartoszycki","Sępopol, gm.","280106",5454,1784,1784,1753,946,807
"warmińsko-mazurskie","braniewski","Braniewo, gm.","280202",4703,1493,1493,1482,819,663
"warmińsko-mazurskie","braniewski","Braniewo, m.","280201",14115,6641,6640,6563,2744,3819
"warmińsko-mazurskie","braniewski","Frombork, gm.","280203",3162,1250,1250,1239,493,746
"warmińsko-mazurskie","braniewski","Lelkowo, gm.","280204",2503,779,778,770,455,315
"warmińsko-mazurskie","braniewski","Pieniężno, gm.","280205",5661,1847,1847,1824,1058,766
"warmińsko-mazurskie","braniewski","Płoskinia, gm.","280206",2040,689,689,678,372,306
"warmińsko-mazurskie","braniewski","Wilczęta, gm.","280207",2512,749,749,742,432,310
"warmińsko-mazurskie","działdowski","Działdowo, gm.","280302",7249,2618,2618,2593,1455,1138
"warmińsko-mazurskie","działdowski","Działdowo, m.","280301",17048,8024,8020,7956,3931,4025
"warmińsko-mazurskie","działdowski","Iłowo-Osada, gm.","280303",5447,2173,2173,2146,1278,868
"warmińsko-mazurskie","działdowski","Lidzbark, gm.","280304",11369,4725,4724,4680,2816,1864
"warmińsko-mazurskie","działdowski","Płośnica, gm.","280305",4634,1603,1603,1592,1025,567
"warmińsko-mazurskie","działdowski","Rybno, gm.","280306",5470,2626,2625,2599,1742,857
"warmińsko-mazurskie","elbląski","Elbląg, gm.","280401",5159,1880,1880,1864,1046,818
"warmińsko-mazurskie","elbląski","Godkowo, gm.","280402",2726,791,791,778,563,215
"warmińsko-mazurskie","elbląski","Gronowo Elbląskie, gm.","280403",3754,1385,1385,1371,656,715
"warmińsko-mazurskie","elbląski","Markusy, gm.","280404",3020,1047,1047,1036,651,385
"warmińsko-mazurskie","elbląski","Milejewo, gm.","280405",2265,850,850,841,510,331
"warmińsko-mazurskie","elbląski","Młynary, gm.","280406",3450,1416,1416,1402,800,602
"warmińsko-mazurskie","elbląski","Pasłęk, gm.","280407",15316,5984,5983,5933,2986,2947
"warmińsko-mazurskie","elbląski","Rychliki, gm.","280408",3208,1025,1025,1010,497,513
"warmińsko-mazurskie","elbląski","Tolkmicko, gm.","280409",5079,2045,2045,2018,952,1066
"warmińsko-mazurskie","ełcki","Ełk, gm.","280502",7567,2526,2526,2483,1289,1194
"warmińsko-mazurskie","ełcki","Ełk, m.","280501",43240,19328,19322,19085,9916,9169
"warmińsko-mazurskie","ełcki","Kalinowo, gm.","280503",5312,1805,1805,1747,962,785
"warmińsko-mazurskie","ełcki","Prostki, gm.","280504",5699,1728,1727,1690,908,782
"warmińsko-mazurskie","ełcki","Stare Juchy, gm.","280505",3126,1079,1078,1072,634,438
"warmińsko-mazurskie","giżycki","Giżycko, gm.","280604",5849,2151,2151,2056,970,1086
"warmińsko-mazurskie","giżycki","Giżycko, m.","280601",24339,11414,11414,11219,4578,6641
"warmińsko-mazurskie","giżycki","Kruklanki, gm.","280605",2414,844,844,796,415,381
"warmińsko-mazurskie","giżycki","Miłki, gm.","280606",3015,964,964,956,499,457
"warmińsko-mazurskie","giżycki","Ryn, gm.","280608",4787,1800,1800,1767,716,1051
"warmińsko-mazurskie","giżycki","Wydminy, gm.","280610",5239,1914,1914,1878,908,970
"warmińsko-mazurskie","iławski","Iława, gm.","280703",8504,3328,3327,3303,1859,1444
"warmińsko-mazurskie","iławski","Iława, m.","280701",27434,14403,14402,14220,6515,7705
"warmińsko-mazurskie","iławski","Kisielice, gm.","280704",4762,1642,1642,1618,996,622
"warmińsko-mazurskie","iławski","Lubawa, gm.","280705",7616,3651,3649,3596,2543,1053
"warmińsko-mazurskie","iławski","Lubawa, m.","280702",7087,3833,3827,3788,1971,1817
"warmińsko-mazurskie","iławski","Susz, gm.","280706",9757,3314,3312,3290,1640,1650
"warmińsko-mazurskie","iławski","Zalewo, gm.","280707",5658,1673,1673,1656,801,855
"warmińsko-mazurskie","kętrzyński","Barciany, gm.","280802",5499,1644,1644,1617,773,844
"warmińsko-mazurskie","kętrzyński","Kętrzyn, gm.","280803",6370,2162,2162,2142,909,1233
"warmińsko-mazurskie","kętrzyński","Kętrzyn, m.","280801",23581,10610,10606,10455,4414,6041
"warmińsko-mazurskie","kętrzyński","Korsze, gm.","280804",8790,2957,2955,2924,1390,1534
"warmińsko-mazurskie","kętrzyński","Reszel, gm.","280805",6902,2691,2691,2647,1178,1469
"warmińsko-mazurskie","kętrzyński","Srokowo, gm.","280806",3371,1295,1295,1279,537,742
"warmińsko-mazurskie","lidzbarski","Kiwity, gm.","280902",2708,1013,1013,1003,620,383
"warmińsko-mazurskie","lidzbarski","Lidzbark Warmiński, gm.","280903",5173,1600,1600,1584,850,734
"warmińsko-mazurskie","lidzbarski","Lidzbark Warmiński, m.","280901",13387,6301,6300,6238,2700,3538
"warmińsko-mazurskie","lidzbarski","Lubomino, gm.","280904",2797,953,953,943,533,410
"warmińsko-mazurskie","lidzbarski","Orneta, gm.","280905",10131,4010,4009,3976,2028,1948
"warmińsko-mazurskie","mrągowski","Mikołajki, gm.","281002",6845,2923,2923,2867,1158,1709
"warmińsko-mazurskie","mrągowski","Mrągowo, gm.","281003",5772,2019,2018,1996,950,1046
"warmińsko-mazurskie","mrągowski","Mrągowo, m.","281001",17654,8709,8708,8603,3703,4900
"warmińsko-mazurskie","mrągowski","Piecki, gm.","281004",5955,2539,2539,2514,1399,1115
"warmińsko-mazurskie","mrągowski","Sorkwity, gm.","281005",3642,1349,1349,1327,626,701
"warmińsko-mazurskie","nidzicki","Janowiec Kościelny, gm.","281101",2694,1007,1007,993,747,246
"warmińsko-mazurskie","nidzicki","Janowo, gm.","281102",2291,909,909,898,594,304
"warmińsko-mazurskie","nidzicki","Kozłowo, gm.","281103",4773,1605,1605,1549,895,654
"warmińsko-mazurskie","nidzicki","Nidzica, gm.","281104",16976,7545,7543,7439,3920,3519
"warmińsko-mazurskie","nowomiejski","Biskupiec, gm.","281202",7369,3110,3110,3067,1738,1329
"warmińsko-mazurskie","nowomiejski","Grodziczno, gm.","281203",4715,2103,2100,2084,1575,509
"warmińsko-mazurskie","nowomiejski","Kurzętnik, gm.","281204",6665,2760,2760,2727,1700,1027
"warmińsko-mazurskie","nowomiejski","Nowe Miasto Lubawskie, gm.","281205",5824,2431,2431,2401,1454,947
"warmińsko-mazurskie","nowomiejski","Nowe Miasto Lubawskie, m.","281201",8534,4254,4252,4195,2078,2117
"warmińsko-mazurskie","olecki","Kowale Oleckie, gm.","281303",4247,1383,1383,1351,848,503
"warmińsko-mazurskie","olecki","Olecko, gm.","281304",16629,7197,7195,7099,4141,2958
"warmińsko-mazurskie","olecki","Świętajno, gm.","281305",3143,1032,1032,1017,552,465
"warmińsko-mazurskie","olecki","Wieliczki, gm.","281306",2616,979,979,968,599,369
"warmińsko-mazurskie","olsztyński","Barczewo, gm.","281401",13092,5672,5672,5592,2354,3238
"warmińsko-mazurskie","olsztyński","Biskupiec, gm.","281402",15325,6367,6366,6286,2643,3643
"warmińsko-mazurskie","olsztyński","Dobre Miasto, gm.","281403",12634,5319,5319,5219,2764,2455
"warmińsko-mazurskie","olsztyński","Dywity, gm.","281404",6620,3168,3168,3139,1293,1846
"warmińsko-mazurskie","olsztyński","Gietrzwałd, gm.","281405",4100,1725,1725,1692,708,984
"warmińsko-mazurskie","olsztyński","Jeziorany, gm.","281406",6299,2126,2126,2094,1110,984
"warmińsko-mazurskie","olsztyński","Jonkowo, gm.","281407",4196,1738,1737,1723,711,1012
"warmińsko-mazurskie","olsztyński","Kolno, gm.","281408",2789,924,923,902,432,470
"warmińsko-mazurskie","olsztyński","Olsztynek, gm.","281409",10455,4308,4308,4254,1951,2303
"warmińsko-mazurskie","olsztyński","Purda, gm.","281410",5734,2193,2193,2152,875,1277
"warmińsko-mazurskie","olsztyński","Stawiguda, gm.","281411",3850,1742,1742,1722,595,1127
"warmińsko-mazurskie","olsztyński","Świątki, gm.","281412",3154,1111,1110,1091,602,489
"warmińsko-mazurskie","ostródzki","Dąbrówno, gm.","281502",3375,1334,1334,1318,772,546
"warmińsko-mazurskie","ostródzki","Grunwald, gm.","281503",4358,1353,1353,1336,675,661
"warmińsko-mazurskie","ostródzki","Łukta, gm.","281504",3269,1168,1168,1157,474,683
"warmińsko-mazurskie","ostródzki","Małdyty, gm.","281505",5141,1487,1487,1472,676,796
"warmińsko-mazurskie","ostródzki","Miłakowo, gm.","281506",4544,1506,1506,1475,742,733
"warmińsko-mazurskie","ostródzki","Miłomłyn, gm.","281507",3937,1599,1599,1578,677,901
"warmińsko-mazurskie","ostródzki","Morąg, gm.","281508",19638,7598,7596,7521,3238,4283
"warmińsko-mazurskie","ostródzki","Ostróda, gm.","281509",11504,4555,4555,4512,2167,2345
"warmińsko-mazurskie","ostródzki","Ostróda, m.","281501",27912,13594,13591,13423,5771,7652
"warmińsko-mazurskie","piski","Biała Piska, gm.","281601",9278,3440,3440,3414,2118,1296
"warmińsko-mazurskie","piski","Orzysz, gm.","281602",7610,2924,2924,2890,1270,1620
"warmińsko-mazurskie","piski","Pisz, gm.","281603",21012,9221,9221,9141,4944,4197
"warmińsko-mazurskie","piski","Ruciane-Nida, gm.","281604",6947,3302,3302,3234,1661,1573
"warmińsko-mazurskie","szczycieński","Dźwierzuty, gm.","281702",5346,1871,1871,1820,924,896
"warmińsko-mazurskie","szczycieński","Jedwabno, gm.","281703",2820,1209,1209,1196,579,617
"warmińsko-mazurskie","szczycieński","Pasym, gm.","281704",3958,1655,1655,1626,682,944
"warmińsko-mazurskie","szczycieński","Rozogi, gm.","281705",4231,1785,1785,1744,1205,539
"warmińsko-mazurskie","szczycieński","Szczytno, gm.","281706",7678,2761,2761,2729,1437,1292
"warmińsko-mazurskie","szczycieński","Szczytno, m.","281701",21050,10317,10317,10170,4543,5627
"warmińsko-mazurskie","szczycieński","Świętajno, gm.","281707",4784,1955,1955,1924,1024,900
"warmińsko-mazurskie","szczycieński","Wielbark, gm.","281708",4835,1846,1846,1819,915,904
"warmińsko-mazurskie","gołdapski","Banie Mazurskie, gm.","281801",3294,940,940,926,486,440
"warmińsko-mazurskie","gołdapski","Dubeninki, gm.","281802",2574,851,851,832,541,291
"warmińsko-mazurskie","gołdapski","Gołdap, gm.","281803",15417,5782,5781,5715,2661,3054
"warmińsko-mazurskie","węgorzewski","Budry, gm.","281901",2512,734,733,721,446,275
"warmińsko-mazurskie","węgorzewski","Pozezdrze, gm.","281902",2795,953,953,941,459,482
"warmińsko-mazurskie","węgorzewski","Węgorzewo, gm.","281903",14137,5616,5613,5527,2159,3368
"warmińsko-mazurskie","Elbląg","Elbląg, m.","286101",100041,52468,52459,51819,22558,29261
"warmińsko-mazurskie","Olsztyn","Olsztyn, m.","286201",134862,77537,77516,76296,30643,45653
"wielkopolskie","chodzieski","Budzyń, gm.","300102",6248,2764,2764,2731,1397,1334
"wielkopolskie","chodzieski","Chodzież, gm.","300103",4143,2065,2065,2038,902,1136
"wielkopolskie","chodzieski","Chodzież, m.","300101",16094,8547,8544,8392,2937,5455
"wielkopolskie","chodzieski","Margonin, gm.","300104",4711,2281,2281,2237,1071,1166
"wielkopolskie","chodzieski","Szamocin, gm.","300105",5483,2711,2711,2673,1263,1410
"wielkopolskie","czarnkowsko-trzcianecki","Czarnków, gm.","300202",7996,3625,3625,3575,1733,1842
"wielkopolskie","czarnkowsko-trzcianecki","Czarnków, m.","300201",9487,5036,5036,4991,1975,3016
"wielkopolskie","czarnkowsko-trzcianecki","Drawsko, gm.","300203",4583,2112,2112,2087,989,1098
"wielkopolskie","czarnkowsko-trzcianecki","Krzyż Wielkopolski, gm.","300204",6880,2989,2989,2948,1240,1708
"wielkopolskie","czarnkowsko-trzcianecki","Lubasz, gm.","300205",5168,2503,2503,2472,1262,1210
"wielkopolskie","czarnkowsko-trzcianecki","Połajewo, gm.","300206",4617,2046,2045,2027,1262,765
"wielkopolskie","czarnkowsko-trzcianecki","Trzcianka, gm.","300207",18647,9506,9506,9412,3918,5494
"wielkopolskie","czarnkowsko-trzcianecki","Wieleń, gm.","300208",9939,4477,4477,4416,2142,2274
"wielkopolskie","gnieźnieński","Czerniejewo, gm.","300302",5934,2880,2880,2839,1416,1423
"wielkopolskie","gnieźnieński","Gniezno, gm.","300303",6143,2784,2784,2765,1764,1001
"wielkopolskie","gnieźnieński","Gniezno, m.","300301",56286,31016,30992,30621,13698,16923
"wielkopolskie","gnieźnieński","Kiszkowo, gm.","300304",4005,1831,1831,1807,1081,726
"wielkopolskie","gnieźnieński","Kłecko, gm.","300305",5771,2678,2667,2619,1670,949
"wielkopolskie","gnieźnieński","Łubowo, gm.","300306",3946,1784,1784,1768,1100,668
"wielkopolskie","gnieźnieński","Mieleszyn, gm.","300307",2955,1241,1240,1227,792,435
"wielkopolskie","gnieźnieński","Niechanowo, gm.","300308",3935,1889,1889,1858,1266,592
"wielkopolskie","gnieźnieński","Trzemeszno, gm.","300309",11039,4863,4862,4776,2807,1969
"wielkopolskie","gnieźnieński","Witkowo, gm.","300310",10460,5247,5247,5161,3093,2068
"wielkopolskie","gostyński","Borek Wielkopolski, gm.","300401",5847,2324,2324,2295,1275,1020
"wielkopolskie","gostyński","Gostyń, gm.","300402",21811,10756,10756,10636,4946,5690
"wielkopolskie","gostyński","Krobia, gm.","300403",9811,4388,4388,4323,2568,1755
"wielkopolskie","gostyński","Pępowo, gm.","300404",4548,2018,2016,1993,1244,749
"wielkopolskie","gostyński","Piaski, gm.","300405",6254,2871,2871,2824,1615,1209
"wielkopolskie","gostyński","Pogorzela, gm.","300406",3869,1661,1660,1635,1091,544
"wielkopolskie","gostyński","Poniec, gm.","300407",6074,2467,2464,2437,1499,938
"wielkopolskie","grodziski","Granowo, gm.","300501",3598,1722,1722,1690,1108,582
"wielkopolskie","grodziski","Grodzisk Wielkopolski, gm.","300502",14241,6921,6921,6853,3065,3788
"wielkopolskie","grodziski","Kamieniec, gm.","300503",4889,2224,2220,2192,1291,901
"wielkopolskie","grodziski","Rakoniewice, gm.","300504",9250,3833,3831,3790,1966,1824
"wielkopolskie","grodziski","Wielichowo, gm.","300505",5115,2448,2446,2406,1367,1039
"wielkopolskie","jarociński","Jaraczewo, gm.","300601",6236,2856,2856,2807,1757,1050
"wielkopolskie","jarociński","Jarocin, gm.","300602",35188,16510,16509,16268,8269,7999
"wielkopolskie","jarociński","Kotlin, gm.","300603",5360,2174,2171,2141,1328,813
"wielkopolskie","jarociński","Żerków, gm.","300604",8109,3645,3645,3610,2366,1244
"wielkopolskie","kaliski","Blizanów, gm.","300701",7121,2988,2988,2948,2076,872
"wielkopolskie","kaliski","Brzeziny, gm.","300702",4455,1850,1849,1834,1358,476
"wielkopolskie","kaliski","Ceków-Kolonia, gm.","300703",3663,1373,1373,1355,902,453
"wielkopolskie","kaliski","Godziesze Wielkie, gm.","300704",6467,2961,2961,2947,2230,717
"wielkopolskie","kaliski","Koźminek, gm.","300705",5825,2510,2508,2488,1888,600
"wielkopolskie","kaliski","Lisków, gm.","300706",4216,1735,1734,1711,1202,509
"wielkopolskie","kaliski","Mycielin, gm.","300707",3795,1357,1357,1322,939,383
"wielkopolskie","kaliski","Opatówek, gm.","300708",7984,3988,3988,3963,2741,1222
"wielkopolskie","kaliski","Stawiszyn, gm.","300709",5752,2479,2479,2458,1616,842
"wielkopolskie","kaliski","Szczytniki, gm.","300710",6134,2762,2762,2741,2239,502
"wielkopolskie","kaliski","Żelazków, gm.","300711",6879,3334,3334,3300,2469,831
"wielkopolskie","kępiński","Baranów, gm.","300801",5626,2848,2848,2824,1820,1004
"wielkopolskie","kępiński","Bralin, gm.","300802",4274,2205,2205,2189,1228,961
"wielkopolskie","kępiński","Kępno, gm.","300803",19234,9791,9791,9663,4592,5071
"wielkopolskie","kępiński","Łęka Opatowska, gm.","300804",3903,1847,1847,1821,1024,797
"wielkopolskie","kępiński","Perzów, gm.","300805",2935,1240,1240,1235,775,460
"wielkopolskie","kępiński","Rychtal, gm.","300806",3071,1269,1269,1252,774,478
"wielkopolskie","kępiński","Trzcinica, gm.","300807",3611,1750,1750,1725,1145,580
"wielkopolskie","kolski","Babiak, gm.","300902",6173,2604,2604,2575,1988,587
"wielkopolskie","kolski","Chodów, gm.","300903",2875,971,970,959,710,249
"wielkopolskie","kolski","Dąbie, gm.","300904",5413,2396,2396,2378,1877,501
"wielkopolskie","kolski","Grzegorzew, gm.","300905",4325,1879,1879,1866,1375,491
"wielkopolskie","kolski","Kłodawa, gm.","300906",10747,4608,4608,4564,3384,1180
"wielkopolskie","kolski","Koło, gm.","300907",5411,2339,2338,2314,1726,588
"wielkopolskie","kolski","Koło, m.","300901",19175,9700,9699,9580,5238,4342
"wielkopolskie","kolski","Kościelec, gm.","300908",5004,2121,2121,2102,1539,563
"wielkopolskie","kolski","Olszówka, gm.","300909",3806,1563,1553,1546,1339,207
"wielkopolskie","kolski","Osiek Mały, gm.","300910",4338,1892,1892,1884,1572,312
"wielkopolskie","kolski","Przedecz, gm.","300911",3528,1281,1281,1264,983,281
"wielkopolskie","koniński","Golina, gm.","301001",8763,4053,4053,4013,2790,1223
"wielkopolskie","koniński","Grodziec, gm.","301002",3907,1621,1620,1593,1153,440
"wielkopolskie","koniński","Kazimierz Biskupi, gm.","301003",7751,3684,3684,3659,2601,1058
"wielkopolskie","koniński","Kleczew, gm.","301004",7309,3439,3429,3386,2517,869
"wielkopolskie","koniński","Kramsk, gm.","301005",7639,3509,3509,3490,2600,890
"wielkopolskie","koniński","Krzymów, gm.","301006",5199,2505,2505,2487,1829,658
"wielkopolskie","koniński","Rychwał, gm.","301007",6361,2990,2990,2951,2235,716
"wielkopolskie","koniński","Rzgów, gm.","301008",5159,2313,2313,2292,1634,658
"wielkopolskie","koniński","Skulsk, gm.","301009",4757,1789,1789,1778,1278,500
"wielkopolskie","koniński","Sompolno, gm.","301010",8133,3475,3474,3459,2678,781
"wielkopolskie","koniński","Stare Miasto, gm.","301011",7456,3790,3790,3755,2466,1289
"wielkopolskie","koniński","Ślesin, gm.","301012",10216,4445,4445,4400,2927,1473
"wielkopolskie","koniński","Wierzbinek, gm.","301013",5866,2318,2317,2275,1848,427
"wielkopolskie","koniński","Wilczyn, gm.","301014",4881,1962,1960,1941,1383,558
"wielkopolskie","kościański","Czempiń, gm.","301102",8657,3950,3944,3890,1856,2034
"wielkopolskie","kościański","Kościan, gm.","301103",11206,5160,5158,5059,2673,2386
"wielkopolskie","kościański","Kościan, m.","301101",19716,10520,10514,10350,4247,6103
"wielkopolskie","kościański","Krzywiń, gm.","301104",7467,3569,3567,3527,2279,1248
"wielkopolskie","kościański","Śmigiel, gm.","301105",13405,6386,6385,6290,3366,2924
"wielkopolskie","krotoszyński","Kobylin, gm.","301202",6152,2894,2894,2851,1696,1155
"wielkopolskie","krotoszyński","Koźmin Wielkopolski, gm.","301203",10718,5039,5039,4971,2992,1979
"wielkopolskie","krotoszyński","Krotoszyn, gm.","301204",31472,16207,16200,16016,8474,7542
"wielkopolskie","krotoszyński","Rozdrażew, gm.","301205",3846,1727,1727,1708,1344,364
"wielkopolskie","krotoszyński","Sulmierzyce, m.","301201",2060,1049,1049,1035,488,547
"wielkopolskie","krotoszyński","Zduny, gm.","301206",5269,2313,2313,2271,1203,1068
"wielkopolskie","leszczyński","Krzemieniewo, gm.","301301",6433,2832,2832,2791,1404,1387
"wielkopolskie","leszczyński","Lipno, gm.","301302",4213,2105,2105,2077,1014,1063
"wielkopolskie","leszczyński","Osieczna, gm.","301303",6583,2998,2998,2963,1558,1405
"wielkopolskie","leszczyński","Rydzyna, gm.","301304",6070,3154,3153,3113,1482,1631
"wielkopolskie","leszczyński","Święciechowa, gm.","301305",5361,2439,2437,2405,1096,1309
"wielkopolskie","leszczyński","Wijewo, gm.","301306",2570,1173,1173,1146,659,487
"wielkopolskie","leszczyński","Włoszakowice, gm.","301307",6358,3202,3202,3133,1568,1565
"wielkopolskie","międzychodzki","Chrzypsko Wielkie, gm.","301401",2504,1026,1026,1010,571,439
"wielkopolskie","międzychodzki","Kwilcz, gm.","301402",4651,1792,1792,1756,746,1010
"wielkopolskie","międzychodzki","Międzychód, gm.","301403",14266,6434,6434,6295,2690,3605
"wielkopolskie","międzychodzki","Sieraków, gm.","301404",6668,2774,2774,2718,1157,1561
"wielkopolskie","nowotomyski","Kuślin, gm.","301501",4031,1721,1721,1700,994,706
"wielkopolskie","nowotomyski","Lwówek, gm.","301502",6931,2929,2929,2886,1419,1467
"wielkopolskie","nowotomyski","Miedzichowo, gm.","301503",2950,1373,1372,1357,588,769
"wielkopolskie","nowotomyski","Nowy Tomyśl, gm.","301504",18730,9651,9649,9515,3889,5626
"wielkopolskie","nowotomyski","Opalenica, gm.","301505",12037,6056,6055,5988,2818,3170
"wielkopolskie","nowotomyski","Zbąszyń, gm.","301506",10252,5128,5128,5031,2139,2892
"wielkopolskie","obornicki","Oborniki, gm.","301601",24453,12091,12088,11938,5364,6574
"wielkopolskie","obornicki","Rogoźno, gm.","301602",13197,6235,6235,6153,3042,3111
"wielkopolskie","obornicki","Ryczywół, gm.","301603",5416,2577,2577,2543,1456,1087
"wielkopolskie","ostrowski","Nowe Skalmierzyce, gm.","301702",11666,5321,5318,5273,3239,2034
"wielkopolskie","ostrowski","Odolanów, gm.","301703",10357,5738,5736,5686,3859,1827
"wielkopolskie","ostrowski","Ostrów Wielkopolski, gm.","301704",13563,6539,6535,6470,4179,2291
"wielkopolskie","ostrowski","Ostrów Wielkopolski, m.","301701",59395,32190,32184,31798,14587,17211
"wielkopolskie","ostrowski","Przygodzice, gm.","301705",8539,4431,4431,4384,2688,1696
"wielkopolskie","ostrowski","Raszków, gm.","301706",8537,3938,3935,3910,2711,1199
"wielkopolskie","ostrowski","Sieroszewice, gm.","301707",7230,3235,3234,3201,2371,830
"wielkopolskie","ostrowski","Sośnie, gm.","301708",4838,2231,2231,2213,1356,857
"wielkopolskie","ostrzeszowski","Czajków, gm.","301801",1942,808,808,793,590,203
"wielkopolskie","ostrzeszowski","Doruchów, gm.","301802",3788,1772,1772,1740,1189,551
"wielkopolskie","ostrzeszowski","Grabów nad Prosną, gm.","301803",5932,2761,2761,2721,1834,887
"wielkopolskie","ostrzeszowski","Kobyla Góra, gm.","301804",4400,1968,1968,1913,1078,835
"wielkopolskie","ostrzeszowski","Kraszewice, gm.","301805",2768,1203,1203,1193,816,377
"wielkopolskie","ostrzeszowski","Mikstat, gm.","301806",4763,1997,1997,1966,1416,550
"wielkopolskie","ostrzeszowski","Ostrzeszów, gm.","301807",18146,8405,8396,8261,4191,4070
"wielkopolskie","pilski","Białośliwie, gm.","301902",3651,1774,1774,1752,930,822
"wielkopolskie","pilski","Kaczory, gm.","301903",5535,3078,3078,3032,1505,1527
"wielkopolskie","pilski","Łobżenica, gm.","301904",7415,3718,3718,3665,2485,1180
"wielkopolskie","pilski","Miasteczko Krajeńskie, gm.","301905",2406,1209,1209,1197,630,567
"wielkopolskie","pilski","Piła, m.","301901",59202,32405,32402,32049,12728,19321
"wielkopolskie","pilski","Szydłowo, gm.","301906",5609,2457,2457,2432,1133,1299
"wielkopolskie","pilski","Ujście, gm.","301907",6147,2820,2820,2778,1265,1513
"wielkopolskie","pilski","Wyrzysk, gm.","301908",10747,5260,5260,5192,2663,2529
"wielkopolskie","pilski","Wysoka, gm.","301909",5121,2384,2382,2359,1162,1197
"wielkopolskie","pleszewski","Chocz, gm.","302001",3608,1450,1449,1429,830,599
"wielkopolskie","pleszewski","Czermin, gm.","302002",3741,1688,1687,1658,1219,439
"wielkopolskie","pleszewski","Dobrzyca, gm.","302003",6350,2879,2879,2810,1726,1084
"wielkopolskie","pleszewski","Gizałki, gm.","302004",3481,1360,1360,1337,919,418
"wielkopolskie","pleszewski","Gołuchów, gm.","302005",7423,3504,3504,3437,2169,1268
"wielkopolskie","pleszewski","Pleszew, gm.","302006",23526,10784,10784,10631,5170,5461
"wielkopolskie","poznański","Buk, gm.","302103",8922,4973,4972,4923,2696,2227
"wielkopolskie","poznański","Czerwonak, gm.","302104",18270,10295,10293,10197,3528,6669
"wielkopolskie","poznański","Dopiewo, gm.","302105",9732,5569,5567,5512,2280,3232
"wielkopolskie","poznański","Kleszczewo, gm.","302106",3687,1947,1947,1931,962,969
"wielkopolskie","poznański","Komorniki, gm.","302107",10296,5777,5774,5719,2204,3515
"wielkopolskie","poznański","Kostrzyn, gm.","302108",12024,5736,5730,5658,2682,2976
"wielkopolskie","poznański","Kórnik, gm.","302109",12769,7043,7039,6958,3062,3896
"wielkopolskie","poznański","Luboń, m.","302101",20096,11743,11743,11653,4367,7286
"wielkopolskie","poznański","Mosina, gm.","302110",19548,10862,10860,10752,4441,6311
"wielkopolskie","poznański","Murowana Goślina, gm.","302111",11674,5821,5820,5764,2216,3548
"wielkopolskie","poznański","Pobiedziska, gm.","302112",12267,6272,6272,6216,2561,3655
"wielkopolskie","poznański","Puszczykowo, m.","302102",7393,4631,4629,4568,1487,3081
"wielkopolskie","poznański","Rokietnica, gm.","302113",6720,3457,3456,3396,1344,2052
"wielkopolskie","poznański","Stęszew, gm.","302114",10542,4963,4959,4884,2284,2600
"wielkopolskie","poznański","Suchy Las, gm.","302115",9308,5853,5852,5797,1877,3920
"wielkopolskie","poznański","Swarzędz, gm.","302116",30376,17782,17778,17622,6591,11031
"wielkopolskie","poznański","Tarnowo Podgórne, gm.","302117",13847,8340,8340,8267,3062,5205
"wielkopolskie","rawicki","Bojanowo, gm.","302201",6828,2879,2878,2822,1366,1456
"wielkopolskie","rawicki","Jutrosin, gm.","302202",5292,2245,2245,2199,1339,860
"wielkopolskie","rawicki","Miejska Górka, gm.","302203",7171,2937,2935,2887,1720,1167
"wielkopolskie","rawicki","Pakosław, gm.","302204",3437,1653,1653,1616,901,715
"wielkopolskie","rawicki","Rawicz, gm.","302205",23947,11470,11465,11316,4835,6481
"wielkopolskie","słupecki","Lądek, gm.","302302",4493,1941,1941,1918,1410,508
"wielkopolskie","słupecki","Orchowo, gm.","302303",3025,1255,1255,1233,837,396
"wielkopolskie","słupecki","Ostrowite, gm.","302304",3981,1641,1641,1635,1196,439
"wielkopolskie","słupecki","Powidz, gm.","302305",1697,1059,1059,1036,602,434
"wielkopolskie","słupecki","Słupca, gm.","302306",6851,2804,2804,2781,2024,757
"wielkopolskie","słupecki","Słupca, m.","302301",11905,6099,6099,6021,3029,2992
"wielkopolskie","słupecki","Strzałkowo, gm.","302307",7329,3343,3343,3283,1987,1296
"wielkopolskie","słupecki","Zagórów, gm.","302308",7017,2640,2640,2597,1688,909
"wielkopolskie","szamotulski","Duszniki, gm.","302402",6226,3012,3012,2977,1838,1139
"wielkopolskie","szamotulski","Kaźmierz, gm.","302403",5315,2371,2371,2346,1037,1309
"wielkopolskie","szamotulski","Obrzycko, gm.","302404",3254,1163,1163,1150,596,554
"wielkopolskie","szamotulski","Obrzycko, m.","302401",1762,900,898,886,409,477
"wielkopolskie","szamotulski","Ostroróg, gm.","302405",3747,1499,1499,1473,779,694
"wielkopolskie","szamotulski","Pniewy, gm.","302406",9239,4330,4329,4254,2006,2248
"wielkopolskie","szamotulski","Szamotuły, gm.","302407",22451,11134,11131,11009,4512,6497
"wielkopolskie","szamotulski","Wronki, gm.","302408",16267,7588,7587,7480,2885,4595
"wielkopolskie","średzki","Dominowo, gm.","302501",2122,919,919,907,609,298
"wielkopolskie","średzki","Krzykosy, gm.","302502",4882,2172,2172,2145,1335,810
"wielkopolskie","średzki","Nowe Miasto nad Wartą, gm.","302503",6840,2950,2950,2914,1645,1269
"wielkopolskie","średzki","Środa Wielkopolska, gm.","302504",23667,12096,12094,11921,5512,6409
"wielkopolskie","średzki","Zaniemyśl, gm.","302505",4711,2367,2366,2327,1110,1217
"wielkopolskie","śremski","Brodnica, gm.","302601",3598,1546,1546,1522,669,853
"wielkopolskie","śremski","Dolsk, gm.","302602",4310,1762,1761,1748,1041,707
"wielkopolskie","śremski","Książ Wielkopolski, gm.","302603",6306,2763,2763,2725,1623,1102
"wielkopolskie","śremski","Śrem, gm.","302604",31196,16297,16293,16089,7237,8852
"wielkopolskie","turecki","Brudzew, gm.","302702",4669,2016,2016,1998,1561,437
"wielkopolskie","turecki","Dobra, gm.","302703",5006,2266,2265,2228,1635,593
"wielkopolskie","turecki","Kawęczyn, gm.","302704",4115,1782,1782,1757,1428,329
"wielkopolskie","turecki","Malanów, gm.","302705",4774,1741,1741,1717,1170,547
"wielkopolskie","turecki","Przykona, gm.","302706",3156,1359,1358,1350,1114,236
"wielkopolskie","turecki","Tuliszków, gm.","302707",7963,3418,3418,3395,2405,990
"wielkopolskie","turecki","Turek, gm.","302708",5589,2467,2466,2440,1790,650
"wielkopolskie","turecki","Turek, m.","302701",24152,12473,12471,12310,6891,5419
"wielkopolskie","turecki","Władysławów, gm.","302709",5809,2913,2913,2886,2294,592
"wielkopolskie","wągrowiecki","Damasławek, gm.","302802",4358,2173,2173,2148,1414,734
"wielkopolskie","wągrowiecki","Gołańcz, gm.","302803",6407,2964,2961,2901,1670,1231
"wielkopolskie","wągrowiecki","Mieścisko, gm.","302804",4468,2061,2059,2035,1224,811
"wielkopolskie","wągrowiecki","Skoki, gm.","302805",6457,2804,2803,2774,1430,1344
"wielkopolskie","wągrowiecki","Wapno, gm.","302806",2458,946,946,921,506,415
"wielkopolskie","wągrowiecki","Wągrowiec, gm.","302807",8382,3485,3485,3453,2291,1162
"wielkopolskie","wągrowiecki","Wągrowiec, m.","302801",19418,10198,10195,10066,4564,5502
"wielkopolskie","wolsztyński","Przemęt, gm.","302901",10127,4655,4651,4594,2471,2123
"wielkopolskie","wolsztyński","Siedlec, gm.","302902",8932,3900,3899,3821,1913,1908
"wielkopolskie","wolsztyński","Wolsztyn, gm.","302903",22515,11987,11985,11803,4746,7057
"wielkopolskie","wrzesiński","Kołaczkowo, gm.","303001",4612,2200,2200,2175,1454,721
"wielkopolskie","wrzesiński","Miłosław, gm.","303002",8102,3784,3784,3724,1911,1813
"wielkopolskie","wrzesiński","Nekla, gm.","303003",5056,2466,2464,2435,1391,1044
"wielkopolskie","wrzesiński","Pyzdry, gm.","303004",5634,2335,2334,2308,1495,813
"wielkopolskie","wrzesiński","Września, gm.","303005",34368,18312,18305,18088,8942,9146
"wielkopolskie","złotowski","Jastrowie, gm.","303102",8869,4104,4104,4061,1599,2462
"wielkopolskie","złotowski","Krajenka, gm.","303103",5476,2569,2568,2527,1241,1286
"wielkopolskie","złotowski","Lipka, gm.","303104",4310,1749,1749,1720,771,949
"wielkopolskie","złotowski","Okonek, gm.","303105",7024,2892,2892,2846,1314,1532
"wielkopolskie","złotowski","Tarnówka, gm.","303106",2384,1012,1012,1005,525,480
"wielkopolskie","złotowski","Zakrzewo, gm.","303107",3501,1755,1754,1727,958,769
"wielkopolskie","złotowski","Złotów, gm.","303108",6722,2649,2649,2612,1354,1258
"wielkopolskie","złotowski","Złotów, m.","303101",14967,7538,7536,7394,3085,4309
"wielkopolskie","Kalisz","Kalisz, m.","306101",86764,46594,46581,46087,21076,25011
"wielkopolskie","Konin","Konin, m.","306201",64759,35716,35709,35294,18306,16988
"wielkopolskie","Leszno","Leszno, m.","306301",50527,28072,28062,27746,9529,18217
"wielkopolskie","Poznań","Poznań, m.","306401",454440,281508,281302,278514,92680,185834
"zachodniopomorskie","białogardzki","Białogard, gm.","320102",6034,1798,1798,1784,837,947
"zachodniopomorskie","białogardzki","Białogard, m.","320101",19354,8912,8912,8801,3779,5022
"zachodniopomorskie","białogardzki","Karlino, gm.","320103",7092,2464,2463,2432,1182,1250
"zachodniopomorskie","białogardzki","Tychowo, gm.","320104",5415,1925,1925,1906,777,1129
"zachodniopomorskie","choszczeński","Bierzwnik, gm.","320201",3927,1436,1434,1421,676,745
"zachodniopomorskie","choszczeński","Choszczno, gm.","320202",18261,7362,7345,7283,3166,4117
"zachodniopomorskie","choszczeński","Drawno, gm.","320203",4258,1532,1532,1503,610,893
"zachodniopomorskie","choszczeński","Krzęcin, gm.","320204",3065,805,805,801,406,395
"zachodniopomorskie","choszczeński","Pełczyce, gm.","320205",6346,2143,2142,2114,1110,1004
"zachodniopomorskie","choszczeński","Recz, gm.","320206",4496,1337,1336,1326,635,691
"zachodniopomorskie","drawski","Czaplinek, gm.","320301",9426,3491,3491,3462,1485,1977
"zachodniopomorskie","drawski","Drawsko Pomorskie, gm.","320302",13276,5661,5661,5596,2316,3280
"zachodniopomorskie","drawski","Kalisz Pomorski, gm.","320303",5766,1998,1998,1978,735,1243
"zachodniopomorskie","drawski","Ostrowice, gm.","320304",2011,726,726,715,443,272
"zachodniopomorskie","drawski","Wierzchowo, gm.","320305",4125,1780,1780,1755,559,1196
"zachodniopomorskie","drawski","Złocieniec, gm.","320306",12524,5314,5313,5250,2559,2691
"zachodniopomorskie","goleniowski","Goleniów, gm.","320402",26671,12474,12455,12328,4391,7937
"zachodniopomorskie","goleniowski","Maszewo, gm.","320403",6160,2139,2135,2115,976,1139
"zachodniopomorskie","goleniowski","Nowogard, gm.","320404",19875,8370,8366,8246,3351,4895
"zachodniopomorskie","goleniowski","Osina, gm.","320405",2175,832,832,824,389,435
"zachodniopomorskie","goleniowski","Przybiernów, gm.","320406",4064,1398,1396,1388,748,640
"zachodniopomorskie","goleniowski","Stepnica, gm.","320407",3723,1245,1245,1234,428,806
"zachodniopomorskie","gryficki","Brojce, gm.","320501",2898,808,808,801,350,451
"zachodniopomorskie","gryficki","Gryfice, gm.","320502",19322,8334,8317,8217,3315,4902
"zachodniopomorskie","gryficki","Karnice, gm.","320503",3310,1117,1117,1109,517,592
"zachodniopomorskie","gryficki","Płoty, gm.","320504",7276,2946,2946,2911,1284,1627
"zachodniopomorskie","gryficki","Rewal, gm.","320507",2833,1486,1485,1467,567,900
"zachodniopomorskie","gryficki","Trzebiatów, gm.","320508",13075,4964,4964,4910,2006,2904
"zachodniopomorskie","gryfiński","Banie, gm.","320601",5053,1769,1768,1751,819,932
"zachodniopomorskie","gryfiński","Cedynia, gm.","320602",3450,971,971,960,385,575
"zachodniopomorskie","gryfiński","Chojna, gm.","320603",10714,4428,4428,4363,1891,2472
"zachodniopomorskie","gryfiński","Gryfino, gm.","320604",24768,12171,12170,12039,5491,6548
"zachodniopomorskie","gryfiński","Mieszkowice, gm.","320605",5767,2357,2356,2338,1218,1120
"zachodniopomorskie","gryfiński","Moryń, gm.","320606",3449,1242,1242,1228,610,618
"zachodniopomorskie","gryfiński","Stare Czarnowo, gm.","320607",2969,1253,1252,1242,591,651
"zachodniopomorskie","gryfiński","Trzcińsko-Zdrój, gm.","320608",4510,1513,1513,1499,757,742
"zachodniopomorskie","gryfiński","Widuchowa, gm.","320609",4236,1378,1378,1358,665,693
"zachodniopomorskie","kamieński","Dziwnów, gm.","320701",3445,1628,1627,1618,598,1020
"zachodniopomorskie","kamieński","Golczewo, gm.","320702",4745,1950,1950,1933,862,1071
"zachodniopomorskie","kamieński","Kamień Pomorski, gm.","320703",12018,5217,5215,5134,1972,3162
"zachodniopomorskie","kamieński","Międzyzdroje, gm.","320704",5402,2528,2528,2506,1004,1502
"zachodniopomorskie","kamieński","Świerzno, gm.","320705",3255,1062,1062,1051,342,709
"zachodniopomorskie","kamieński","Wolin, gm.","320706",9857,3708,3708,3662,1515,2147
"zachodniopomorskie","kołobrzeski","Dygowo, gm.","320802",4123,1491,1491,1474,647,827
"zachodniopomorskie","kołobrzeski","Gościno, gm.","320803",3893,1353,1353,1341,622,719
"zachodniopomorskie","kołobrzeski","Kołobrzeg, gm.","320804",6865,3102,3101,3076,1143,1933
"zachodniopomorskie","kołobrzeski","Kołobrzeg, m.","320801",37608,19367,19361,19131,7419,11712
"zachodniopomorskie","kołobrzeski","Rymań, gm.","320805",3211,1199,1199,1186,637,549
"zachodniopomorskie","kołobrzeski","Siemyśl, gm.","320806",2653,1041,1041,1031,532,499
"zachodniopomorskie","kołobrzeski","Ustronie Morskie, gm.","320807",2907,1247,1247,1230,495,735
"zachodniopomorskie","koszaliński","Będzino, gm.","320901",7097,2728,2727,2695,1318,1377
"zachodniopomorskie","koszaliński","Biesiekierz, gm.","320902",3878,1626,1626,1622,703,919
"zachodniopomorskie","koszaliński","Bobolice, gm.","320903",7957,2878,2878,2842,1293,1549
"zachodniopomorskie","koszaliński","Manowo, gm.","320904",4723,1996,1996,1980,729,1251
"zachodniopomorskie","koszaliński","Mielno, gm.","320905",4051,2056,2056,2038,898,1140
"zachodniopomorskie","koszaliński","Polanów, gm.","320906",6948,2321,2321,2300,1023,1277
"zachodniopomorskie","koszaliński","Sianów, gm.","320907",10014,4239,4237,4195,2081,2114
"zachodniopomorskie","koszaliński","Świeszyno, gm.","320908",4279,1865,1865,1832,766,1066
"zachodniopomorskie","myśliborski","Barlinek, gm.","321001",15476,6631,6626,6548,2871,3677
"zachodniopomorskie","myśliborski","Boleszkowice, gm.","321002",2210,796,796,781,387,394
"zachodniopomorskie","myśliborski","Dębno, gm.","321003",16265,7173,7173,7090,3106,3984
"zachodniopomorskie","myśliborski","Myślibórz, gm.","321004",16777,6696,6693,6622,2881,3741
"zachodniopomorskie","myśliborski","Nowogródek Pomorski, gm.","321005",2522,906,906,899,374,525
"zachodniopomorskie","policki","Dobra (Szczecińska), gm.","321101",8267,4527,4526,4494,1316,3178
"zachodniopomorskie","policki","Kołbaskowo, gm.","321102",6210,2979,2978,2953,975,1978
"zachodniopomorskie","policki","Nowe Warpno, gm.","321103",1328,597,595,589,181,408
"zachodniopomorskie","policki","Police, gm.","321104",32098,16048,16036,15884,5750,10134
"zachodniopomorskie","pyrzycki","Bielice, gm.","321201",2232,744,744,736,480,256
"zachodniopomorskie","pyrzycki","Kozielice, gm.","321202",2056,782,782,774,412,362
"zachodniopomorskie","pyrzycki","Lipiany, gm.","321203",4982,1994,1994,1970,1057,913
"zachodniopomorskie","pyrzycki","Przelewice, gm.","321204",4289,1250,1249,1229,557,672
"zachodniopomorskie","pyrzycki","Pyrzyce, gm.","321205",15752,6877,6877,6794,3327,3467
"zachodniopomorskie","pyrzycki","Warnice, gm.","321206",2686,865,865,856,560,296
"zachodniopomorskie","sławieński","Darłowo, gm.","321303",5792,2328,2328,2301,1311,990
"zachodniopomorskie","sławieński","Darłowo, m.","321301",11854,5235,5234,5170,2347,2823
"zachodniopomorskie","sławieński","Malechowo, gm.","321304",5030,1601,1601,1587,950,637
"zachodniopomorskie","sławieński","Postomino, gm.","321305",5353,1823,1823,1803,964,839
"zachodniopomorskie","sławieński","Sławno, gm.","321306",6494,2136,2136,2108,1116,992
"zachodniopomorskie","sławieński","Sławno, m.","321302",10677,4910,4910,4847,2343,2504
"zachodniopomorskie","stargardzki","Chociwel, gm.","321402",4756,1730,1730,1723,781,942
"zachodniopomorskie","stargardzki","Dobrzany, gm.","321403",4006,1393,1393,1378,717,661
"zachodniopomorskie","stargardzki","Dolice, gm.","321404",6226,2193,2193,2174,963,1211
"zachodniopomorskie","stargardzki","Ińsko, gm.","321405",2911,1110,1110,1083,440,643
"zachodniopomorskie","stargardzki","Kobylanka, gm.","321406",2748,1266,1266,1244,539,705
"zachodniopomorskie","stargardzki","Marianowo, gm.","321408",2380,948,947,937,463,474
"zachodniopomorskie","stargardzki","Stara Dąbrowa, gm.","321409",2718,884,884,872,400,472
"zachodniopomorskie","stargardzki","Stargard Szczeciński, gm.","321410",8610,3080,3080,3049,1396,1653
"zachodniopomorskie","stargardzki","Stargard Szczeciński, m.","321401",56637,28681,28673,28376,11638,16738
"zachodniopomorskie","stargardzki","Suchań, gm.","321411",3351,1160,1160,1157,508,649
"zachodniopomorskie","szczecinecki","Barwice, gm.","321502",7014,2456,2456,2410,1097,1313
"zachodniopomorskie","szczecinecki","Biały Bór, gm.","321503",4106,1528,1528,1510,638,872
"zachodniopomorskie","szczecinecki","Borne Sulinowo, gm.","321504",6830,2656,2656,2623,1060,1563
"zachodniopomorskie","szczecinecki","Grzmiąca, gm.","321505",4027,1307,1307,1289,555,734
"zachodniopomorskie","szczecinecki","Szczecinek, gm.","321506",7556,2709,2708,2678,1231,1447
"zachodniopomorskie","szczecinecki","Szczecinek, m.","321501",31972,16113,16106,15970,6815,9155
"zachodniopomorskie","świdwiński","Brzeżno, gm.","321602",2181,764,764,757,355,402
"zachodniopomorskie","świdwiński","Połczyn-Zdrój, gm.","321603",13293,5381,5381,5313,2520,2793
"zachodniopomorskie","świdwiński","Rąbino, gm.","321604",3165,1093,1093,1080,563,517
"zachodniopomorskie","świdwiński","Sławoborze, gm.","321605",3286,1108,1108,1101,462,639
"zachodniopomorskie","świdwiński","Świdwin, gm.","321606",4813,1749,1747,1724,774,950
"zachodniopomorskie","świdwiński","Świdwin, m.","321601",12639,5551,5551,5478,2245,3233
"zachodniopomorskie","wałecki","Człopa, gm.","321702",3971,1452,1451,1424,576,848
"zachodniopomorskie","wałecki","Mirosławiec, gm.","321703",4632,1687,1687,1665,632,1033
"zachodniopomorskie","wałecki","Tuczno, gm.","321704",4032,1501,1501,1478,609,869
"zachodniopomorskie","wałecki","Wałcz, gm.","321705",9399,3359,3359,3323,1313,2010
"zachodniopomorskie","wałecki","Wałcz, m.","321701",21138,10324,10319,10195,3870,6325
"zachodniopomorskie","łobeski","Dobra, gm.","321801",3576,1149,1149,1137,505,632
"zachodniopomorskie","łobeski","Łobez, gm.","321802",11557,4794,4793,4742,1954,2788
"zachodniopomorskie","łobeski","Radowo Małe, gm.","321803",2982,891,891,881,310,571
"zachodniopomorskie","łobeski","Resko, gm.","321804",6548,2476,2475,2430,973,1457
"zachodniopomorskie","łobeski","Węgorzyno, gm.","321805",5708,2095,2094,2071,1090,981
"zachodniopomorskie","Koszalin","Koszalin, m.","326101",87914,46456,46438,45913,18403,27510
"zachodniopomorskie","Szczecin","Szczecin, m.","326201",325782,182419,182280,180563,71296,109267
"zachodniopomorskie","Świnoujście","Świnoujście, m.","326301",33707,16808,16805,16642,6212,10430
"zachodniopomorskie","Statki","Statki","329901",48,48,48,45,21,24
